# Postags to extend the binary postagger, generated from database.
#
# Dot not add entries here, but report them on the forum.
#
bloedveeg	bloedveeg	ZNW:EKV:DE_
eigenaarschap	eigenaarschap	ZNW:EKV:HET
gebid	gebid	ZNW:EKV:HET
geneesmiddelenwet	geneesmiddelenwet	ZNW:EKV:DE_
geneesmiddelenwetten	geneesmiddelenwet	ZNW:MRV:DE_
heenkomen	heenkomen	WKW:INF:ZNW:HET
leve	leven	WKW:AWS
slachtafval	slachtafval	ZNW:EKV:HET
geotextiel	geotextiel	ZNW:EKV:HET
slotevent	slotevent	ZNW:EKV:HET
bijdoen	bijdoen	WKW:TGW:INF
hartoverslag	hartoverslag	ZNW:EKV:DE_
samenvattingstaken	samenvattingstaak	ZNW:MRV:DE_
tandemassen	tandemas	ZNW:MRV:DE_
operatiejassen	operatiejas	ZNW:MRV:DE_
servicepassen	servicepas	ZNW:MRV:DE_
zendingsdagen	zendingsdag	ZNW:MRV:DE_
moeraskatten	moeraskat	ZNW:MRV:DE_
kansspelwetten	kansspelwet	ZNW:MRV:DE_
bijdeden	bijdoen	WKW:VLT:INF
bijdeed	bijdoen	WKW:VLT:1EP
bijdoe	bijdoen	WKW:TGW:1EP
bijdoe	bijdoen	WKW:AWS
bijdoend	bijdoen	WKW:ODW:ONV
bijdoende	bijdoen	WKW:ODW:VRB
bijdoet	bijdoen	WKW:TGW:3EP
bijdoenden	bijdoen	WKW:ODW:MRV:DE_
bijgedaan	bijdoen	WKW:VTD:ONV
bijgedanen	bijdoen	WKW:VTD:ZNW:MRV:DE_
bijgedane	bijdoen	WKW:VTD:VRB
bijdeedt	bijdoen	WKW:VLT:GIJ
eenoudervakanties	eenoudervakantie	ZNW:MRV:DE_
smalband	smalband	ZNW:EKV
busk	busk	ZNW:EKV:DE_
XL	XL	BNW:STL:ONV
scale-up	scale-up	ZNW:EKV:DE_
guard	guard	ZNW:EKV:DE_
Ubud	Ubud	ENM:LOC:PTS
wortelboorders	wortelboorder	ZNW:MRV:DE_
knock-outbod	knock-outbod	ZNW:EKV:HET
lay-outer	lay-outer	ZNW:EKV:DE_
struggle	struggle	ZNW:EKV:DE_
americana	americana	ZNW:EKV
Turks-Armeens	Turks-Armeens	BNW:STL:ONV
fascia	fascia	ZNW:EKV:DE_
must-hear	must-hear	ZNW:EKV:DE_
septum	septum	ZNW:EKV:HET
hydro-ureter	hydro-ureter	ZNW:EKV:DE_
turnkey	turnkey	BNW:STL:ONV
nurture	nurture	ZNW:EKV:DE_
hook	hook	ZNW:EKV:DE_
overnight	overnight	BNW:STL:ONV
coccidiose	coccidiose	ZNW:EKV:DE_
binge-eating	binge-eating	ZNW:EKV
carbamazepine	carbamazepine	ZNW:EKV
thumbnail	thumbnail	ZNW:EKV:DE_
ctrl	ctrl	ZNW:EKV:DE_
downhill	downhill	BNW:STL:ONV
arousal	arousal	ZNW:EKV:DE_
OMG	OMG	TSW
iron	iron	ZNW:EKV
gyproc	gyproc	ZNW:EKV:DE_
lose-losesituatie	lose-losesituatie	ZNW:EKV:DE_
sildenafil	sildenafil	ZNW:EKV
sh'bam	sh'bam	ZNW:EKV:DE_
cache-coeur	cache-coeur	ZNW:EKV:DE_
healthcare	healthcare	ZNW:EKV:DE_
oeil-de-boeuf	oeil-de-boeuf	ZNW:EKV:DE_
stratum	stratum	ZNW:EKV
session	session	ZNW:EKV:DE_
MDMA	MDMA	ZNW:EKV:DE_
anyway	anyway	TSW
lifecycle	lifecycle	ZNW:EKV:DE_
asap	asap	BYW
booze	booze	ZNW:EKV:DE_
televisie-interviewster	televisie-interviewster	ZNW:EKV:DE_
cal	cal	MEH:EKV
camerlengo	camerlengo	ZNW:EKV:DE_
choline	choline	ZNW:EKV
coolingdown	coolingdown	ZNW:EKV:DE_
bradycardie	bradycardie	ZNW:EKV
worker	worker	ZNW:EKV:DE_
nozzle	nozzle	ZNW:EKV:DE_
kosten-batenverhouding	kosten-batenverhouding	ZNW:EKV:DE_
kosten-batenverhoudingen	kosten-batenverhouding	ZNW:MRV:DE_
kosten-batenverhoudinkje	kosten-batenverhouding	ZNW:EKV:VRK:HET
kosten-batenverhoudinkjes	kosten-batenverhouding	ZNW:MRV:VRK:DE_
biotransformatie	biotransformatie	ZNW:EKV:DE_
biotransformaties	biotransformatie	ZNW:MRV:DE_
voorjaarsbloeiend	voorjaarsbloeiend	BNW:STL:ONV
voorjaarsbloeiende	voorjaarsbloeiend	BNW:STL:VRB
valdempend	valdempend	BNW:STL:ONV
valdempende	valdempend	BNW:STL:VRB
dampdoorlatend	dampdoorlatend	BNW:STL:ONV
dampdoorlatende	dampdoorlatend	BNW:STL:VRB
niet-inachtneming	niet-inachtneming	ZNW:EKV:DE_
niet-inachtnemingen	niet-inachtneming	ZNW:MRV:DE_
niet-zelfstandige	niet-zelfstandige	ZNW:EKV:DE_
niet-zelfstandigen	niet-zelfstandige	ZNW:MRV:DE_
niet-beleidsartikel	niet-beleidsartikel	ZNW:EKV:HET
niet-beleidsartikelen	niet-beleidsartikel	ZNW:MRV:DE_
niet-beleidsartikeltje	niet-beleidsartikel	ZNW:EKV:VRK:HET
niet-beleidsartikeltjes	niet-beleidsartikel	ZNW:MRV:VRK:DE_
niet-beleidsartikels	niet-beleidsartikel	ZNW:MRV:DE_
passief-agressief	passief-agressief	BNW:STL:ONV
passief-agressieve	passief-agressief	BNW:STL:VRB
niet-gereguleerd	niet-gereguleerd	BNW:STL:ONV
niet-gereguleerde	niet-gereguleerd	BNW:STL:VRB
medisch-inhoudelijk	medisch-inhoudelijk	BNW:STL:ONV
medisch-inhoudelijke	medisch-inhoudelijk	BNW:STL:VRB
niet-toeristisch	niet-toeristisch	BNW:STL:ONV
niet-toeristische	niet-toeristisch	BNW:STL:VRB
zijlob	zijlob	ZNW:EKV:DE_
zijlobben	zijlob	ZNW:MRV:DE_
zijlobbetje	zijlob	ZNW:EKV:VRK:HET
zijlobbetjes	zijlob	ZNW:MRV:VRK:DE_
zijlobje	zijlob	ZNW:EKV:VRK:HET
zijlobjes	zijlob	ZNW:MRV:VRK:DE_
candida-infectie	candida-infectie	ZNW:EKV:DE_
candida-infecties	candida-infectie	ZNW:MRV:DE_
candida-infectietje	candida-infectie	ZNW:EKV:VRK:HET
candida-infectietjes	candida-infectie	ZNW:MRV:VRK:DE_
oud-rechercheur	oud-rechercheur	ZNW:EKV:DE_
oud-rechercheurs	oud-rechercheur	ZNW:MRV:DE_
oud-rechercheurtje	oud-rechercheur	ZNW:EKV:VRK:HET
oud-rechercheurtjes	oud-rechercheur	ZNW:MRV:VRK:DE_
niet-technologisch	niet-technologisch	BNW:STL:ONV
niet-technologische	niet-technologisch	BNW:STL:VRB
niet-infectieus	niet-infectieus	BNW:STL:ONV
niet-infectieuze	niet-infectieus	BNW:STL:VRB
substituut-ombudsman	substituut-ombudsman	ZNW:EKV:DE_
substituut-ombudsmannen	substituut-ombudsman	ZNW:MRV:DE_
substituut-ombudslieden	substituut-ombudsman	ZNW:MRV:DE_
substituut-ombudslui	substituut-ombudsman	ZNW:MRV:DE_
substituut-ombudsmannetje	substituut-ombudsman	ZNW:EKV:VRK:HET
substituut-ombudsmannetjes	substituut-ombudsman	ZNW:MRV:VRK:DE_
kardinaal-diaken	kardinaal-diaken	ZNW:EKV:DE_
niet-wetenschapper	niet-wetenschapper	ZNW:EKV:DE_
niet-wetenschappers	niet-wetenschapper	ZNW:MRV:DE_
niet-toegewezen	niet-toegewezen	BNW:STL:ONV
niet-toegewezen	niet-toegewezen	BNW:STL:VRB
niet-gecontroleerd	niet-gecontroleerd	BNW:STL:ONV
niet-gecontroleerde	niet-gecontroleerd	BNW:STL:VRB
heldervoelendheid	heldervoelendheid	ZNW:EKV:DE_
chlamydia-infectie	chlamydia-infectie	ZNW:EKV:DE_
chlamydia-infecties	chlamydia-infectie	ZNW:MRV:DE_
chlamydia-infectietje	chlamydia-infectie	ZNW:EKV:VRK:HET
chlamydia-infectietjes	chlamydia-infectie	ZNW:MRV:VRK:DE_
antropoceen	antropoceen	ZNW:EKV:HET
lordschap	lordschap	ZNW:EKV
niet-triviaal	niet-triviaal	BNW:STL:ONV
niet-triviale	niet-triviaal	BNW:STL:VRB
botmineraaldichtheid	botmineraaldichtheid	ZNW:EKV:DE_
botmineraaldichtheden	botmineraaldichtheid	ZNW:MRV:DE_
botmineraaldichtheidje	botmineraaldichtheid	ZNW:EKV:VRK:HET
botmineraaldichtheidjes	botmineraaldichtheid	ZNW:MRV:VRK:DE_
bioluminescentie	bioluminescentie	ZNW:EKV:DE_
ex-schoonmoeder	ex-schoonmoeder	ZNW:EKV:DE_
ex-schoonmoeders	ex-schoonmoeder	ZNW:MRV:DE_
ex-schoonmoedertje	ex-schoonmoeder	ZNW:EKV:VRK:HET
ex-schoonmoeders	ex-schoonmoeder	ZNW:BEZ
ex-schoonmoedertjes	ex-schoonmoeder	ZNW:MRV:VRK:DE_
ergotherapeutisch	ergotherapeutisch	BNW:STL:ONV
ergotherapeutische	ergotherapeutisch	BNW:STL:VRB
Turks-Armeens	Turks-Armeens	BNW:STL:VRB
knock-outbodje	knock-outbod	ZNW:EKV:VRK:HET
knock-outbodjes	knock-outbod	ZNW:MRV:VRK:DE_
karpervissen	karpervissen	WKW:TGW:INF
karpervissend	karpervissen	WKW:ODW:ONV
karpervissende	karpervissen	WKW:ODW:VRB
karpervissenden	karpervissen	WKW:ODW:MRV:DE_
karpervisse	karpervissen	WKW:AWS
hydro-ureters	hydro-ureter	ZNW:MRV:DE_
zonverbranding	zonverbranding	ZNW:EKV:DE_
zonverbrandingen	zonverbranding	ZNW:MRV:DE_
portierkruk	portierkruk	ZNW:EKV:DE_
portierkrukje	portierkruk	ZNW:EKV:VRK:HET
portierkrukjes	portierkruk	ZNW:MRV:VRK:DE_
portierkrukken	portierkruk	ZNW:MRV:DE_
ecotoxicologisch	ecotoxicologisch	BNW:STL:ONV
ecotoxicologische	ecotoxicologisch	BNW:STL:VRB
spuitgietmatrijs	spuitgietmatrijs	ZNW:EKV:DE_
spuitgietmatrijsje	spuitgietmatrijs	ZNW:EKV:VRK:HET
spuitgietmatrijsjes	spuitgietmatrijs	ZNW:MRV:VRK:DE_
spuitgietmatrijzen	spuitgietmatrijs	ZNW:MRV:DE_
poolwervel	poolwervel	ZNW:EKV:DE_
poolwervels	poolwervel	ZNW:MRV:DE_
poolwerveltje	poolwervel	ZNW:EKV:VRK:HET
poolwerveltjes	poolwervel	ZNW:MRV:VRK:DE_
eiswijziging	eiswijziging	ZNW:EKV:DE_
eiswijzigingen	eiswijziging	ZNW:MRV:DE_
eiswijzigingetje	eiswijziging	ZNW:EKV:VRK:HET
eiswijzigingetjes	eiswijziging	ZNW:MRV:VRK:DE_
eiswijziginkjes	eiswijziging	ZNW:MRV:VRK:DE_
ultraslagschip	ultraslagschip	ZNW:EKV:HET
ultraslagschepen	ultraslagschip	ZNW:MRV:DE_
ultraslagscheepje	ultraslagschip	ZNW:EKV:VRK:HET
ultraslagscheepjes	ultraslagschip	ZNW:MRV:VRK:DE_
suboptimalisatie	suboptimalisatie	ZNW:EKV:DE_
suboptimalisaties	suboptimalisatie	ZNW:MRV:DE_
spoorverbreder	spoorverbreder	ZNW:EKV:DE_
spoorverbreders	spoorverbreder	ZNW:MRV:DE_
niet-gemotoriseerde	niet-gemotoriseerd	BNW:STL:VRB
niet-gemotoriseerdsten	niet-gemotoriseerd	BNW:OVR:MRV:DE_
niet-gemotoriseerden	niet-gemotoriseerd	BNW:STL:MRV:DE_
niet-gemotoriseerderen	niet-gemotoriseerd	BNW:VGR:MRV:DE_
allerniet-gemotoriseerdst	niet-gemotoriseerd	BNW:ALR:ONV
allerniet-gemotoriseerdste	niet-gemotoriseerd	BNW:ALR:VRB
allerniet-gemotoriseerdsten	niet-gemotoriseerd	BNW:ALR:MRV:DE_
multidimensionaliteit	multidimensionaliteit	ZNW:EKV:DE_
bodemverbeterend	bodemverbeterend	BNW:STL:ONV
bodemverbeterende	bodemverbeterend	BNW:STL:VRB
waardedrukkend	waardedrukkend	BNW:STL:ONV
waardedrukkende	waardedrukkend	BNW:STL:VRB
verandadeur	verandadeur	ZNW:EKV:DE_
verandadeuren	verandadeur	ZNW:MRV:DE_
verandadeurtje	verandadeur	ZNW:EKV:VRK:HET
verandadeurtjes	verandadeur	ZNW:MRV:VRK:DE_
ranchgebouw	ranchgebouw	ZNW:EKV:HET
ranchgebouwen	ranchgebouw	ZNW:MRV:DE_
ranchgebouwtje	ranchgebouw	ZNW:EKV:VRK:HET
ranchgebouwtjes	ranchgebouw	ZNW:MRV:VRK:DE_
contrastkleurig	contrastkleurig	BNW:STL:ONV
contrastkleurige	contrastkleurig	BNW:STL:VRB
anjerfamilie	anjerfamilie	ZNW:EKV:DE_
anjerfamilies	anjerfamilie	ZNW:MRV:DE_
anjerfamilietje	anjerfamilie	ZNW:EKV:VRK:HET
anjerfamilietjes	anjerfamilie	ZNW:MRV:VRK:DE_
wegnummering	wegnummering	ZNW:EKV:DE_
wegnummeringen	wegnummering	ZNW:MRV:DE_
vereenvoudigingswet	vereenvoudigingswet	ZNW:EKV:DE_
vereenvoudigingswetje	vereenvoudigingswet	ZNW:EKV:VRK:HET
vereenvoudigingswetjes	vereenvoudigingswet	ZNW:MRV:VRK:DE_
vereenvoudigingswetten	vereenvoudigingswet	ZNW:MRV:DE_
transgenderisme	transgenderisme	ZNW:EKV:HET
spitsboogvormig	spitsboogvormig	BNW:STL:ONV
spitsboogvormige	spitsboogvormig	BNW:STL:ONV
reuzenzon	reuzenzon	ZNW:EKV:DE_
reuzenzonnen	reuzenzon	ZNW:MRV:DE_
reuzenzonnetje	reuzenzon	ZNW:EKV:VRK:HET
reuzenzonnetjes	reuzenzon	ZNW:MRV:VRK:DE_
niet-deelname	niet-deelname	ZNW:EKV:DE_
niet-deelnames	niet-deelname	ZNW:MRV:DE_
niet-deelnamen	niet-deelname	ZNW:MRV:DE_
hoofdvaarwegennet	hoofdvaarwegennet	ZNW:EKV:HET
hoofdvaarwegennetje	hoofdvaarwegennet	ZNW:EKV:VRK:HET
hoofdvaarwegennetjes	hoofdvaarwegennet	ZNW:MRV:VRK:DE_
hoofdvaarwegennetten	hoofdvaarwegennet	ZNW:MRV:DE_
fructose-intolerantie	fructose-intolerantie	ZNW:EKV:DE_
fructose-intoleranties	fructose-intolerantie	ZNW:MRV:DE_
fructose-intolerantietjes	fructose-intolerantie	ZNW:MRV:VRK:DE_
financieringsmix	financieringsmix	ZNW:EKV:DE_
financieringsmixen	financieringsmix	ZNW:MRV:DE_
financieringsmixje	financieringsmix	ZNW:EKV:VRK:HET
financieringsmixjes	financieringsmix	ZNW:MRV:VRK:DE_
financieringsmixes	financieringsmix	ZNW:MRV:DE_
buidelmuis	buidelmuis	ZNW:EKV:DE_
buidelmuisje	buidelmuis	ZNW:EKV:VRK:HET
buidelmuisjes	buidelmuis	ZNW:MRV:VRK:DE_
buidelmuizen	buidelmuis	ZNW:MRV:DE_
kwestie-Irak	kwestie-Irak	ZNW:EKV:DE_
interclubcompetitie	interclubcompetitie	ZNW:EKV:DE_
interclubcompetities	interclubcompetitie	ZNW:MRV:DE_
interclubcompetitietje	interclubcompetitie	ZNW:EKV:VRK:HET
interclubcompetitietjes	interclubcompetitie	ZNW:MRV:VRK:DE_
zelfverwaarlozing	zelfverwaarlozing	ZNW:EKV:DE_
zelfverwaarlozingen	zelfverwaarlozing	ZNW:MRV:DE_
ppi	ppi	MEH:EKV
PPI	PPI	ZNW:EKV:DE_
preconceptiezorg	preconceptiezorg	ZNW:EKV:DE_
preconceptiezorgen	preconceptiezorg	ZNW:MRV:DE_
preconceptiezorgje	preconceptiezorg	ZNW:EKV:VRK:HET
preconceptiezorgjes	preconceptiezorg	ZNW:MRV:VRK:DE_
niet-winterhard	niet-winterhard	BNW:STL:ONV
niet-winterharde	niet-winterhard	BNW:STL:VRB
niet-onderbouwd	niet-onderbouwd	BNW:STL:ONV
niet-onderbouwde	niet-onderbouwd	BNW:STL:VRB
neodarwinisme	neodarwinisme	ZNW:EKV:HET
genuitdrukking	genuitdrukking	ZNW:EKV:DE_
genuitdrukkingen	genuitdrukking	ZNW:MRV:DE_
genuitdrukkinkje	genuitdrukking	ZNW:EKV:VRK:HET
genuitdrukkinkjes	genuitdrukking	ZNW:MRV:VRK:DE_
elektrocoagulatie	elektrocoagulatie	ZNW:EKV:DE_
zelfbeschadigend	zelfbeschadigend	BNW:STL:ONV
zelfbeschadigende	zelfbeschadigend	BNW:STL:VRB
worstelaarster	worstelaarster	ZNW:EKV:DE_
worstelaarsters	worstelaarster	ZNW:MRV:DE_
trailschoen	trailschoen	ZNW:EKV:DE_
trailschoenen	trailschoen	ZNW:MRV:DE_
trailschoentje	trailschoen	ZNW:EKV:VRK:HET
trailschoentjes	trailschoen	ZNW:MRV:VRK:DE_
oversubsidiëring	oversubsidiëring	ZNW:EKV:DE_
niet-kapitalistisch	niet-kapitalistisch	BNW:STL:ONV
niet-kapitalistische	niet-kapitalistisch	BNW:STL:VRB
data-infrastructuur	data-infrastructuur	ZNW:EKV:DE_
data-infrastructuren	data-infrastructuur	ZNW:MRV:DE_
data-infrastructuurtje	data-infrastructuur	ZNW:EKV:VRK:HET
data-infrastructuurtjes	data-infrastructuur	ZNW:MRV:VRK:DE_
supergemakkelijk	supergemakkelijk	BNW:STL:ONV
supergemakkelijke	supergemakkelijk	BNW:STL:VRB
grootvee-eenheid	grootvee-eenheid	ZNW:EKV:DE_
grootvee-eenheden	grootvee-eenheid	ZNW:MRV:DE_
grootvee-eenheidje	grootvee-eenheid	ZNW:EKV:VRK:HET
grootvee-eenheidjes	grootvee-eenheid	ZNW:MRV:VRK:DE_
geneesmiddelenwetje	geneesmiddelenwet	ZNW:EKV:VRK:HET
geneesmiddelenwetjes	geneesmiddelenwet	ZNW:MRV:VRK:DE_
geldequivalent	geldequivalent	ZNW:EKV:HET
geldequivalenten	geldequivalent	ZNW:MRV:DE_
geldequivalentjes	geldequivalent	ZNW:MRV:VRK:DE_
geldequivalentje	geldequivalent	ZNW:EKV:VRK:HET
fijntandig	fijntandig	BNW:STL:ONV
fijntandige	fijntandig	BNW:STL:VRB
vochtvasthoudend	vochtvasthoudend	BNW:STL:ONV
vochtvasthoudende	vochtvasthoudend	BNW:STL:VRB
subprefectuur	subprefectuur	ZNW:EKV:DE_
subprefecturen	subprefectuur	ZNW:MRV:DE_
psychofysiologisch	psychofysiologisch	BNW:STL:ONV
psychofysiologische	psychofysiologisch	BNW:STL:VRB
nachtorchis	nachtorchis	ZNW:EKV:DE_
nachtorchisjes	nachtorchis	ZNW:MRV:VRK:DE_
nachtorchissen	nachtorchis	ZNW:MRV:DE_
medisch-technologisch	medisch-technologisch	BNW:STL:ONV
medisch-technologische	medisch-technologisch	BNW:STL:VRB
grootkapitalist	grootkapitalist	ZNW:EKV:DE_
grootkapitalisten	grootkapitalist	ZNW:MRV:DE_
grootkapitalistje	grootkapitalist	ZNW:EKV:VRK:HET
grootkapitalistjes	grootkapitalist	ZNW:MRV:VRK:DE_
voetzoollaesie	voetzoollaesie	ZNW:EKV:DE_
voetzoollaesies	voetzoollaesie	ZNW:MRV:DE_
terawattuur	terawattuur	MEH:EKV
teledetectie	teledetectie	ZNW:EKV:DE_
teledetecties	teledetectie	ZNW:MRV:DE_
tandemas	tandemas	ZNW:EKV:DE_
tandemasje	tandemas	ZNW:EKV:VRK:HET
tandemasjes	tandemas	ZNW:MRV:VRK:DE_
systeemverantwoordelijk	systeemverantwoordelijk	BNW:STL:ONV
systeemverantwoordelijke	systeemverantwoordelijk	BNW:STL:VRB
rekening-courantschuld	rekening-courantschuld	ZNW:EKV:DE_
rekening-courantschulden	rekening-courantschuld	ZNW:MRV:DE_
rekening-courantschuldje	rekening-courantschuld	ZNW:EKV:VRK:HET
rekening-courantschuldjes	rekening-courantschuld	ZNW:MRV:VRK:DE_
ondertemperatuur	ondertemperatuur	ZNW:EKV:DE_
ondertemperaturen	ondertemperatuur	ZNW:MRV:DE_
ondertemperatuurtje	ondertemperatuur	ZNW:EKV:VRK:HET
ondertemperatuurtjes	ondertemperatuur	ZNW:MRV:VRK:DE_
multiculturalistisch	multiculturalistisch	BNW:STL:ONV
multiculturalistische	multiculturalistisch	BNW:STL:VRB
macroprudentieel	macroprudentieel	BNW:STL:ONV
macroprudentiële	macroprudentieel	BNW:STL:VRB
internist-endocrinoloog	internist-endocrinoloog	ZNW:EKV:DE_
internist-endocrinologen	internist-endocrinoloog	ZNW:MRV:DE_
interconnectiviteit	interconnectiviteit	ZNW:EKV:DE_
interconnectiviteiten	interconnectiviteit	ZNW:MRV:DE_
foodproduct	foodproduct	ZNW:EKV:HET
foodproducten	foodproduct	ZNW:MRV:DE_
foodproductje	foodproduct	ZNW:EKV:VRK:HET
foodproductjes	foodproduct	ZNW:MRV:VRK:DE_
dactyloscopisch	dactyloscopisch	BNW:STL:ONV
dactyloscopische	dactyloscopisch	BNW:STL:VRB
bovenkies	bovenkies	ZNW:EKV:DE_
bovenkiesje	bovenkies	ZNW:EKV:VRK:HET
bovenkiesjes	bovenkies	ZNW:MRV:VRK:DE_
bovenkiezen	bovenkies	ZNW:MRV:DE_
admiraal-generaal	admiraal-generaal	ZNW:EKV:DE_
webgroep	webgroep	ZNW:EKV:DE_
webgroepen	webgroep	ZNW:MRV:DE_
webgroepje	webgroep	ZNW:EKV:VRK:HET
webgroepjes	webgroep	ZNW:MRV:VRK:DE_
tibialengte	tibialengte	ZNW:EKV:DE_
tibialengten	tibialengte	ZNW:MRV:DE_
tibialengtes	tibialengte	ZNW:MRV:DE_
tibialengtetje	tibialengte	ZNW:EKV:VRK:HET
tibialengtetjes	tibialengte	ZNW:MRV:VRK:DE_
niet-wetgevend	niet-wetgevend	BNW:STL:ONV
niet-wetgevende	niet-wetgevend	BNW:STL:VRB
niet-vertrouwelijk	niet-vertrouwelijk	BNW:STL:ONV
niet-vertrouwelijke	niet-vertrouwelijk	BNW:STL:VRB
dubbelzon	dubbelzon	ZNW:EKV:DE_
dubbelzonnen	dubbelzon	ZNW:MRV:DE_
dubbelzonnetje	dubbelzon	ZNW:EKV:VRK:HET
dubbelzonnetjes	dubbelzon	ZNW:MRV:VRK:DE_
dagvoorzitterschap	dagvoorzitterschap	ZNW:EKV:HET
dagvoorzitterschapje	dagvoorzitterschap	ZNW:EKV:VRK:HET
dagvoorzitterschapjes	dagvoorzitterschap	ZNW:MRV:VRK:DE_
dagvoorzitterschappen	dagvoorzitterschap	ZNW:MRV:DE_
zoogdierachtige	zoogdierachtige	ZNW:EKV:DE_
zoogdierachtigen	zoogdierachtige	ZNW:MRV:DE_
zoogdierachtig	zoogdierachtig	BNW:STL:ONV
zoogdierachtige	zoogdierachtig	BNW:STL:VRB
weeënactiviteit	weeënactiviteit	ZNW:EKV:DE_
weeënactiviteiten	weeënactiviteit	ZNW:MRV:DE_
weeënactiviteitje	weeënactiviteit	ZNW:EKV:VRK:HET
weeënactiviteitjes	weeënactiviteit	ZNW:MRV:VRK:DE_
subwijk	subwijk	ZNW:EKV:DE_
subwijken	subwijk	ZNW:MRV:DE_
subwijkje	subwijk	ZNW:EKV:VRK:HET
subwijkjes	subwijk	ZNW:MRV:VRK:DE_
semiruimte	semiruimte	ZNW:EKV:DE_
semiruimten	semiruimte	ZNW:MRV:DE_
semiruimtes	semiruimte	ZNW:MRV:DE_
semiruimtetje	semiruimte	ZNW:EKV:VRK:HET
semiruimtetjes	semiruimte	ZNW:MRV:VRK:DE_
korfboogvormig	korfboogvormig	BNW:STL:ONV
korfboogvormige	korfboogvormig	BNW:STL:VRB
houtmot	houtmot	ZNW:EKV:DE_
houtmotje	houtmot	ZNW:EKV:VRK:HET
houtmotjes	houtmot	ZNW:MRV:VRK:DE_
houtmotten	houtmot	ZNW:MRV:DE_
telegeneeskunde	telegeneeskunde	ZNW:EKV:DE_
telegeneeskundes	telegeneeskunde	ZNW:MRV:DE_
supercomfortabel	supercomfortabel	BNW:STL:ONV
supercomfortabele	supercomfortabel	BNW:STL:VRB
zuurstofbindend	zuurstofbindend	BNW:STL:ONV
zuurstofbindende	zuurstofbindend	BNW:STL:VRB
vakheffing	vakheffing	ZNW:EKV:DE_
vakheffingen	vakheffing	ZNW:MRV:DE_
vakheffinkje	vakheffing	ZNW:EKV:VRK:HET
vakheffinkjes	vakheffing	ZNW:MRV:VRK:DE_
samenvattingstaak	samenvattingstaak	ZNW:EKV:DE_
samenvattingstaakje	samenvattingstaak	ZNW:EKV:VRK:HET
samenvattingstaakjes	samenvattingstaak	ZNW:MRV:VRK:DE_
onderworpenheidseis	onderworpenheidseis	ZNW:EKV:DE_
onderworpenheidseisen	onderworpenheidseis	ZNW:MRV:DE_
onderworpenheidseisje	onderworpenheidseis	ZNW:EKV:VRK:HET
onderworpenheidseisjes	onderworpenheidseis	ZNW:MRV:VRK:DE_
niet-overheidsactor	niet-overheidsactor	ZNW:EKV:DE_
niet-overheidsactoren	niet-overheidsactor	ZNW:MRV:DE_
niet-lineariteit	niet-lineariteit	ZNW:EKV:DE_
niet-conformiteit	niet-conformiteit	ZNW:EKV:DE_
niet-conformiteiten	niet-conformiteit	ZNW:MRV:DE_
jongmeerderjarige	jongmeerderjarige	ZNW:EKV:DE_
jongmeerderjarigen	jongmeerderjarige	ZNW:MRV:DE_
vijfkrachtenmodel	vijfkrachtenmodel	ZNW:EKV:HET
vijfkrachtenmodellen	vijfkrachtenmodel	ZNW:MRV:DE_
vijfkrachtenmodelletje	vijfkrachtenmodel	ZNW:EKV:VRK:HET
vijfkrachtenmodelletjes	vijfkrachtenmodel	ZNW:MRV:VRK:DE_
vijfentwintigtal	vijfentwintigtal	ZNW:EKV:HET
vijfentwintigtallen	vijfentwintigtal	ZNW:MRV:DE_
unidirectioneel	unidirectioneel	BNW:STL:ONV
unidirectionele	unidirectioneel	BNW:STL:VRB
spitsmijding	spitsmijding	ZNW:EKV:DE_
spitsmijdingen	spitsmijding	ZNW:MRV:DE_
huidverstrakking	huidverstrakking	ZNW:EKV:DE_
huidverstrakkingen	huidverstrakking	ZNW:MRV:DE_
hoofd-halskanker	hoofd-halskanker	ZNW:EKV:DE_
hoofd-halskankertje	hoofd-halskanker	ZNW:EKV:VRK:HET
hoofd-halskankertjes	hoofd-halskanker	ZNW:MRV:VRK:DE_
hoofd-halskankers	hoofd-halskanker	ZNW:MRV:DE_
geotextieltje	geotextiel	ZNW:EKV:VRK:HET
geotextieltjes	geotextiel	ZNW:MRV:VRK:DE_
footage	footage	ZNW:EKV:DE_
textielen	textiel	ZNW:MRV:DE_
galgo	galgo	ZNW:EKV:DE_
galgo's	galgo	ZNW:MRV:DE_
tolbadge	tolbadge	ZNW:EKV:DE_
tolbadgeje	tolbadge	ZNW:EKV:VRK:HET
tolbadges	tolbadge	ZNW:MRV:DE_
tolbadgejes	tolbadge	ZNW:MRV:VRK:DE_
hartoverslagen	hartoverslag	ZNW:MRV:DE_
hartoverslagje	hartoverslag	ZNW:EKV:VRK:HET
hartoverslagjes	hartoverslag	ZNW:MRV:VRK:DE_
haltafel	haltafel	ZNW:EKV:DE_
haltafels	haltafel	ZNW:MRV:DE_
haltafeltje	haltafel	ZNW:EKV:VRK:HET
haltafeltjes	haltafel	ZNW:MRV:VRK:DE_
haarimplantatie	haarimplantatie	ZNW:EKV:DE_
haarimplantaties	haarimplantatie	ZNW:MRV:DE_
femurkop	femurkop	ZNW:EKV:DE_
femurkopje	femurkop	ZNW:EKV:VRK:HET
femurkopjes	femurkop	ZNW:MRV:VRK:DE_
femurkoppen	femurkop	ZNW:MRV:DE_
annuleerteken	annuleerteken	ZNW:EKV:HET
annuleertekens	annuleerteken	ZNW:MRV:DE_
annuleertekentje	annuleerteken	ZNW:EKV:VRK:HET
annuleertekentjes	annuleerteken	ZNW:MRV:VRK:DE_
annuleertekenen	annuleerteken	ZNW:MRV:DE_
zelfopvoeding	zelfopvoeding	ZNW:EKV:DE_
zelfopvoedingen	zelfopvoeding	ZNW:MRV:DE_
zelfopvoedinkjes	zelfopvoeding	ZNW:MRV:VRK:DE_
stengelomvattend	stengelomvattend	BNW:STL:ONV
stengelomvattende	stengelomvattend	BNW:STL:VRB
niet-ondersteund	niet-ondersteund	BNW:STL:ONV
niet-ondersteunde	niet-ondersteund	BNW:STL:VRB
kortebaandraverij	kortebaandraverij	ZNW:EKV:DE_
kortebaandraverijen	kortebaandraverij	ZNW:MRV:DE_
gevorderdencursus	gevorderdencursus	ZNW:EKV:DE_
gevorderdencursusje	gevorderdencursus	ZNW:EKV:VRK:HET
gevorderdencursusjes	gevorderdencursus	ZNW:MRV:VRK:DE_
gevorderdencursussen	gevorderdencursus	ZNW:MRV:DE_
enkelverstuiking	enkelverstuiking	ZNW:EKV:DE_
enkelverstuikingen	enkelverstuiking	ZNW:MRV:DE_
sportpodotherapeut	sportpodotherapeut	ZNW:EKV:DE_
sportpodotherapeuten	sportpodotherapeut	ZNW:MRV:DE_
servicepas	servicepas	ZNW:EKV:DE_
servicepasje	servicepas	ZNW:EKV:VRK:HET
servicepasjes	servicepas	ZNW:MRV:VRK:DE_
schedelkam	schedelkam	ZNW:EKV:DE_
schedelkammen	schedelkam	ZNW:MRV:DE_
schedelkammetje	schedelkam	ZNW:EKV:VRK:HET
schedelkammetjes	schedelkam	ZNW:MRV:VRK:DE_
ontbureaucratisering	ontbureaucratisering	ZNW:EKV:DE_
niet-Brits	niet-Brits	BNW:STL:ONV
niet-Britse	niet-Brits	BNW:STL:VRB
multiplicatoreffect	multiplicatoreffect	ZNW:EKV:HET
multiplicatoreffecten	multiplicatoreffect	ZNW:MRV:DE_
multiplicatoreffectje	multiplicatoreffect	ZNW:EKV:VRK:HET
multiplicatoreffectjes	multiplicatoreffect	ZNW:MRV:VRK:DE_
multicentrisch	multicentrisch	BNW:STL:ONV
multicentrische	multicentrisch	BNW:STL:VRB
mede-eigenaarschap	mede-eigenaarschap	ZNW:EKV:HET
havermoutvlok	havermoutvlok	ZNW:EKV:DE_
havermoutvlokje	havermoutvlok	ZNW:EKV:VRK:HET
havermoutvlokjes	havermoutvlok	ZNW:MRV:VRK:DE_
havermoutvlokken	havermoutvlok	ZNW:MRV:DE_
tyrosine	tyrosine	ZNW:EKV
ecoregio	ecoregio	ZNW:EKV:DE_
ecoregio's	ecoregio	ZNW:MRV:DE_
ecoregiootje	ecoregio	ZNW:EKV:VRK:HET
ecoregiootjes	ecoregio	ZNW:MRV:VRK:DE_
ecoregionen	ecoregio	ZNW:MRV:DE_
chirurgijnsgilde	chirurgijnsgilde	ZNW:EKV
chirurgijnsgilden	chirurgijnsgilde	ZNW:MRV:DE_
chirurgijnsgildes	chirurgijnsgilde	ZNW:MRV:DE_
broninhouding	broninhouding	ZNW:EKV:DE_
broninhoudingen	broninhouding	ZNW:MRV:DE_
broninhoudinkjes	broninhouding	ZNW:MRV:VRK:DE_
scoot	scoot	ZNW:EKV:DE_
resistance	resistance	ZNW:EKV:DE_
beautyblender	beautyblender	ZNW:EKV:DE_
beautyblenders	beautyblender	ZNW:MRV:DE_
beautyblendertje	beautyblender	ZNW:EKV:VRK:HET
beautyblendertjes	beautyblender	ZNW:MRV:VRK:DE_
ahornstroop	ahornstroop	ZNW:EKV
zesdimensionaal	zesdimensionaal	BNW:STL:ONV
zesdimensionale	zesdimensionaal	BNW:STL:VRB
webcomic	webcomic	ZNW:EKV
webcomics	webcomic	ZNW:MRV:DE_
trombocytenaggregatieremmer	trombocytenaggregatieremmer	ZNW:EKV:DE_
trombocytenaggregatieremmers	trombocytenaggregatieremmer	ZNW:MRV:DE_
trombocytenaggregatieremmertje	trombocytenaggregatieremmer	ZNW:EKV:VRK:HET
trombocytenaggregatieremmertjes	trombocytenaggregatieremmer	ZNW:MRV:VRK:DE_
terugvloeiing	terugvloeiing	ZNW:EKV:DE_
terugvloeiingen	terugvloeiing	ZNW:MRV:DE_
's-Gravelands	's-Gravelands	BNW:STL:ONV
's-Gravelandse	's-Gravelands	BNW:STL:VRB
postcrossing	postcrossing	ZNW:EKV:DE_
kipstuk	kipstuk	ZNW:EKV:HET
kipstukje	kipstuk	ZNW:EKV:VRK:HET
kipstukjes	kipstuk	ZNW:MRV:VRK:DE_
kipstukken	kipstuk	ZNW:MRV:DE_
kipstuks	kipstuk	ZNW:MRV:DE_
bve-instelling	bve-instelling	ZNW:EKV:DE_
bve-instellingen	bve-instelling	ZNW:MRV:DE_
bve-instellinkje	bve-instelling	ZNW:EKV:VRK:HET
bve-instellinkjes	bve-instelling	ZNW:MRV:VRK:DE_
anesthesiologisch	anesthesiologisch	BNW:STL:ONV
anesthesiologische	anesthesiologisch	BNW:STL:VRB
zesruitsvenster	zesruitsvenster	ZNW:EKV:HET
zesruitsvensters	zesruitsvenster	ZNW:MRV:DE_
zesruitsvenstertje	zesruitsvenster	ZNW:EKV:VRK:HET
zesruitsvenstertjes	zesruitsvenster	ZNW:MRV:VRK:DE_
zendingsdag	zendingsdag	ZNW:EKV:DE_
zendingsdagje	zendingsdag	ZNW:EKV:VRK:HET
zendingsdagjes	zendingsdag	ZNW:MRV:VRK:DE_
wolfskop	wolfskop	ZNW:EKV:DE_
wolfskopje	wolfskop	ZNW:EKV:VRK:HET
wolfskopjes	wolfskop	ZNW:MRV:VRK:DE_
wolfskoppen	wolfskop	ZNW:MRV:DE_
weermagie	weermagie	ZNW:EKV:DE_
vollegrondsteelt	vollegrondsteelt	ZNW:EKV:DE_
vollegrondsteelten	vollegrondsteelt	ZNW:MRV:DE_
vleermuisachtig	vleermuisachtig	BNW:STL:ONV
vleermuisachtige	vleermuisachtig	BNW:STL:VRB
vleermuisachtige	vleermuisachtige	ZNW:EKV:DE_
vleermuisachtigen	vleermuisachtige	ZNW:MRV:DE_
transitiepad	transitiepad	ZNW:EKV:HET
transitiepaadje	transitiepad	ZNW:EKV:VRK:HET
transitiepaadjes	transitiepad	ZNW:MRV:VRK:DE_
transitiepaden	transitiepad	ZNW:MRV:DE_
transitiepadje	transitiepad	ZNW:EKV:VRK:HET
transitiepadjes	transitiepad	ZNW:MRV:VRK:DE_
stenografe	stenografe	ZNW:EKV:DE_
stenografes	stenografe	ZNW:MRV:DE_
schrifttype	schrifttype	ZNW:EKV:HET
schrifttypen	schrifttype	ZNW:MRV:DE_
schrifttypes	schrifttype	ZNW:MRV:DE_
schrifttypetje	schrifttype	ZNW:EKV:VRK:HET
schrifttypetjes	schrifttype	ZNW:MRV:VRK:DE_
orthopedagoog-generalist	orthopedagoog-generalist	ZNW:EKV:DE_
orthopedagoog-generalisten	orthopedagoog-generalist	ZNW:MRV:DE_
orthopedagoog-generalistje	orthopedagoog-generalist	ZNW:EKV:VRK:HET
orthopedagoog-generalistjes	orthopedagoog-generalist	ZNW:MRV:VRK:DE_
oogspleet	oogspleet	ZNW:EKV:DE_
oogspleetje	oogspleet	ZNW:EKV:VRK:HET
oogspleetjes	oogspleet	ZNW:MRV:VRK:DE_
oogspleten	oogspleet	ZNW:MRV:DE_
niet-stoffelijk	niet-stoffelijk	BNW:STL:ONV
niet-stoffelijke	niet-stoffelijk	BNW:STL:VRB
niet-muzikaal	niet-muzikaal	BNW:STL:ONV
niet-muzikale	niet-muzikaal	BNW:STL:VRB
niet-Engels	niet-Engels	BNW:STL:ONV
niet-Engelse	niet-Engels	BNW:STL:VRB
middentafel	middentafel	ZNW:EKV:DE_
middentafels	middentafel	ZNW:MRV:DE_
middentafeltje	middentafel	ZNW:EKV:VRK:HET
middentafeltjes	middentafel	ZNW:MRV:VRK:DE_
Koranlesje	Koranles	ZNW:EKV:VRK:HET
Koranlesjes	Koranles	ZNW:MRV:VRK:DE_
Koranlessen	Koranles	ZNW:MRV:DE_
kansspelwet	kansspelwet	ZNW:EKV:DE_
kansspelwetje	kansspelwet	ZNW:EKV:VRK:HET
kansspelwetjes	kansspelwet	ZNW:MRV:VRK:DE_
amenorroeduur	amenorroeduur	ZNW:EKV:DE_
afwikkeldienst	afwikkeldienst	ZNW:EKV:DE_
afwikkeldiensten	afwikkeldienst	ZNW:MRV:DE_
afwikkeldienstje	afwikkeldienst	ZNW:EKV:VRK:HET
afwikkeldienstjes	afwikkeldienst	ZNW:MRV:VRK:DE_
aanzegboete	aanzegboete	ZNW:EKV:DE_
aanzegboeten	aanzegboete	ZNW:MRV:DE_
aanzegboetetje	aanzegboete	ZNW:EKV:VRK:HET
aanzegboetetjes	aanzegboete	ZNW:MRV:VRK:DE_
aanzegboetes	aanzegboete	ZNW:MRV:DE_
zijtunnel	zijtunnel	ZNW:EKV:DE_
zijtunnels	zijtunnel	ZNW:MRV:DE_
zijtunneltje	zijtunnel	ZNW:EKV:VRK:HET
zijtunneltjes	zijtunnel	ZNW:MRV:VRK:DE_
webtoegankelijkheid	webtoegankelijkheid	ZNW:EKV:DE_
webtoegankelijkheden	webtoegankelijkheid	ZNW:MRV:DE_
webtoegankelijkheidje	webtoegankelijkheid	ZNW:EKV:VRK:HET
webtoegankelijkheidjes	webtoegankelijkheid	ZNW:MRV:VRK:DE_
kinesitherapeutisch	kinesitherapeutisch	BNW:STL:ONV
kinesitherapeutische	kinesitherapeutisch	BNW:STL:VRB
inleefweek	inleefweek	ZNW:EKV:DE_
inleefweekje	inleefweek	ZNW:EKV:VRK:HET
inleefweekjes	inleefweek	ZNW:MRV:VRK:DE_
inleefweken	inleefweek	ZNW:MRV:DE_
hoofdlector	hoofdlector	ZNW:EKV:DE_
hoofdlectoren	hoofdlector	ZNW:MRV:DE_
hoofdlectors	hoofdlector	ZNW:MRV:DE_
drogestofopbrengst	drogestofopbrengst	ZNW:EKV:DE_
drogestofopbrengsten	drogestofopbrengst	ZNW:MRV:DE_
cellenbad	cellenbad	ZNW:EKV:HET
cellenbaden	cellenbad	ZNW:MRV:DE_
cellenbadje	cellenbad	ZNW:EKV:VRK:HET
cellenbadjes	cellenbad	ZNW:MRV:VRK:DE_
aortastenose	aortastenose	ZNW:EKV:DE_
anti-imperialisme	anti-imperialisme	ZNW:EKV:HET
wespspin	wespspin	ZNW:EKV:DE_
wespspinnen	wespspin	ZNW:MRV:DE_
wespspinnetje	wespspin	ZNW:EKV:VRK:HET
wespspinnetjes	wespspin	ZNW:MRV:VRK:DE_
toppenlijn	toppenlijn	ZNW:EKV:DE_
toppenlijnen	toppenlijn	ZNW:MRV:DE_
toppenlijntje	toppenlijn	ZNW:EKV:VRK:HET
toppenlijntjes	toppenlijn	ZNW:MRV:VRK:DE_
stormtroeper	stormtroeper	ZNW:EKV:DE_
stormtroepers	stormtroeper	ZNW:MRV:DE_
spacentrum	spacentrum	ZNW:EKV:HET
spacentra	spacentrum	ZNW:MRV:DE_
spacentrumpje	spacentrum	ZNW:EKV:VRK:HET
spacentrumpjes	spacentrum	ZNW:MRV:VRK:DE_
spacentrums	spacentrum	ZNW:MRV:DE_
rijderstitel	rijderstitel	ZNW:EKV:DE_
rijderstitels	rijderstitel	ZNW:MRV:DE_
rijderstiteltje	rijderstitel	ZNW:EKV:VRK:HET
rijderstiteltjes	rijderstitel	ZNW:MRV:VRK:DE_
proeftrek	proeftrek	ZNW:EKV:DE_
proeftrekje	proeftrek	ZNW:EKV:VRK:HET
proeftrekjes	proeftrek	ZNW:MRV:VRK:DE_
proeftrekken	proeftrek	ZNW:MRV:DE_
neuropatisch	neuropatisch	BNW:STL:ONV
neuropatische	neuropatisch	BNW:STL:VRB
moeraskat	moeraskat	ZNW:EKV:DE_
moeraskatje	moeraskat	ZNW:EKV:VRK:HET
moeraskatjes	moeraskat	ZNW:MRV:VRK:DE_
loonvormend	loonvormend	BNW:STL:ONV
loonvormende	loonvormend	BNW:STL:VRB
kwartiersdienst	kwartiersdienst	ZNW:EKV:DE_
kwartiersdiensten	kwartiersdienst	ZNW:MRV:DE_
kwartiersdienstje	kwartiersdienst	ZNW:EKV:VRK:HET
kwartiersdienstjes	kwartiersdienst	ZNW:MRV:VRK:DE_
helweek	helweek	ZNW:EKV:DE_
helweekje	helweek	ZNW:EKV:VRK:HET
helweekjes	helweek	ZNW:MRV:VRK:DE_
helweken	helweek	ZNW:MRV:DE_
dagkassa	dagkassa	ZNW:EKV:DE_
dagkassa's	dagkassa	ZNW:MRV:DE_
dagkassaatje	dagkassa	ZNW:EKV:VRK:HET
dagkassaatjes	dagkassa	ZNW:MRV:VRK:DE_
celcommunicatie	celcommunicatie	ZNW:EKV:DE_
celcommunicaties	celcommunicatie	ZNW:MRV:DE_
begrafenisgangers	begrafenisgangers	ZNW:EKV:DE_
begrafenisganger	begrafenisganger	ZNW:EKV:DE_
begrafenisgangers	begrafenisganger	ZNW:MRV:DE_
webplek	webplek	ZNW:EKV:DE_
webplekje	webplek	ZNW:EKV:VRK:HET
webplekjes	webplek	ZNW:MRV:VRK:DE_
webplekken	webplek	ZNW:MRV:DE_
subadministratie	subadministratie	ZNW:EKV:DE_
subadministraties	subadministratie	ZNW:MRV:DE_
subadministratietje	subadministratie	ZNW:EKV:VRK:HET
subadministratietjes	subadministratie	ZNW:MRV:VRK:DE_
röntgenoog	röntgenoog	ZNW:EKV:HET
röntgenogen	röntgenoog	ZNW:MRV:DE_
röntgenoogje	röntgenoog	ZNW:EKV:VRK:HET
röntgenoogjes	röntgenoog	ZNW:MRV:VRK:DE_
rentmeester-generaal	rentmeester-generaal	ZNW:EKV:DE_
opgelatenheid	opgelatenheid	ZNW:EKV:DE_
niet-geldelijk	niet-geldelijk	BNW:STL:ONV
niet-geldelijke	niet-geldelijk	BNW:STL:ONV
niet-geïntegreerd	niet-geïntegreerd	BNW:STL:ONV
niet-geïntegreerde	niet-geïntegreerd	BNW:STL:VRB
mondknevel	mondknevel	ZNW:EKV:DE_
mondknevels	mondknevel	ZNW:MRV:DE_
mondkneveltje	mondknevel	ZNW:EKV:VRK:HET
mondkneveltjes	mondknevel	ZNW:MRV:VRK:DE_
mijnzetel	mijnzetel	ZNW:EKV:DE_
mijnzetelen	mijnzetel	ZNW:MRV:DE_
mijnzetels	mijnzetel	ZNW:MRV:DE_
mijnzeteltje	mijnzetel	ZNW:EKV:VRK:HET
mijnzeteltjes	mijnzetel	ZNW:MRV:VRK:DE_
maanbeschenen	maanbeschenen	BNW:STL:ONV
maanbeschenen	maanbeschenen	BNW:STL:VRB
hyperfysicus	hyperfysicus	ZNW:EKV:DE_
hyperfysici	hyperfysicus	ZNW:MRV:DE_
hyperfysicusje	hyperfysicus	ZNW:EKV:VRK:HET
hyperfysicusjes	hyperfysicus	ZNW:MRV:VRK:DE_
homocysteïnegehalte	homocysteïnegehalte	ZNW:EKV:HET
homocysteïnegehalten	homocysteïnegehalte	ZNW:MRV:DE_
homocysteïnegehaltes	homocysteïnegehalte	ZNW:MRV:DE_
homocysteïnegehaltetjes	homocysteïnegehalte	ZNW:MRV:VRK:DE_
giscorrectie	giscorrectie	ZNW:EKV:DE_
giscorrecties	giscorrectie	ZNW:MRV:DE_
giscorrectietje	giscorrectie	ZNW:EKV:VRK:HET
giscorrectietjes	giscorrectie	ZNW:MRV:VRK:DE_
zonne-instraling	zonne-instraling	ZNW:EKV:DE_
zonne-instralingen	zonne-instraling	ZNW:MRV:DE_
zonne-instralinkje	zonne-instraling	ZNW:EKV:VRK:HET
zonne-instralinkjes	zonne-instraling	ZNW:MRV:VRK:DE_
zitmogelijkheid	zitmogelijkheid	ZNW:EKV:DE_
zitmogelijkheden	zitmogelijkheid	ZNW:MRV:DE_
zitmogelijkheidje	zitmogelijkheid	ZNW:EKV:VRK:HET
zitmogelijkheidjes	zitmogelijkheid	ZNW:MRV:VRK:DE_
vogeluitwerpselen	vogeluitwerpselen	ZNW:MRV:DE_
sprinkhaanzanger	sprinkhaanzanger	ZNW:EKV:DE_
sprinkhaanzangers	sprinkhaanzanger	ZNW:MRV:DE_
sprinkhaanzangertje	sprinkhaanzanger	ZNW:EKV:VRK:HET
sprinkhaanzangertjes	sprinkhaanzanger	ZNW:MRV:VRK:DE_
spreukbeeld	spreukbeeld	ZNW:EKV:HET
spreukbeelden	spreukbeeld	ZNW:MRV:DE_
spreukbeeldje	spreukbeeld	ZNW:EKV:VRK:HET
spreukbeeldjes	spreukbeeld	ZNW:MRV:VRK:DE_
rivierverruimend	rivierverruimend	BNW:STL:ONV
rivierverruimende	rivierverruimend	BNW:STL:VRB
niet-uitkeringsgerechtigde	niet-uitkeringsgerechtigde	ZNW:EKV:DE_
niet-uitkeringsgerechtigden	niet-uitkeringsgerechtigde	ZNW:MRV:DE_
naturelkleurig	naturelkleurig	BNW:STL:ONV
naturelkleurige	naturelkleurig	BNW:STL:VRB
lastenverlichtend	lastenverlichtend	BNW:STL:ONV
lastenverlichtende	lastenverlichtend	BNW:STL:VRB
kruisreactiviteit	kruisreactiviteit	ZNW:EKV:DE_
kruisreactiviteiten	kruisreactiviteit	ZNW:MRV:DE_
kortegolfradio	kortegolfradio	ZNW:EKV:DE_
kortegolfradio's	kortegolfradio	ZNW:MRV:DE_
kortegolfradiootje	kortegolfradio	ZNW:EKV:VRK:HET
kortegolfradiootjes	kortegolfradio	ZNW:MRV:VRK:DE_
hulpwikkeling	hulpwikkeling	ZNW:EKV:DE_
hulpwikkelingen	hulpwikkeling	ZNW:MRV:DE_
hulpwikkelingetje	hulpwikkeling	ZNW:EKV:VRK:HET
hulpwikkelingetjes	hulpwikkeling	ZNW:MRV:VRK:DE_
geheeltallig	geheeltallig	BNW:STL:ONV
geheeltallige	geheeltallig	BNW:STL:VRB
gedachte-impuls	gedachte-impuls	ZNW:EKV:DE_
gedachte-impulsen	gedachte-impuls	ZNW:MRV:DE_
gedachte-impulsje	gedachte-impuls	ZNW:EKV:VRK:HET
gedachte-impulsjes	gedachte-impuls	ZNW:MRV:VRK:DE_
dematerialisering	dematerialisering	ZNW:EKV:DE_
decarbonisatie	decarbonisatie	ZNW:EKV:DE_
bankoverboeking	bankoverboeking	ZNW:EKV:DE_
bankoverboekingen	bankoverboeking	ZNW:MRV:DE_
bankoverboekinkje	bankoverboeking	ZNW:EKV:VRK:HET
bankoverboekinkjes	bankoverboeking	ZNW:MRV:VRK:DE_
vastestoffysica	vastestoffysica	ZNW:EKV:DE_
subbrandcompartiment	subbrandcompartiment	ZNW:EKV:HET
subbrandcompartimenten	subbrandcompartiment	ZNW:MRV:DE_
subbrandcompartimentje	subbrandcompartiment	ZNW:EKV:VRK:HET
subbrandcompartimentjes	subbrandcompartiment	ZNW:MRV:VRK:DE_
semi-elektrisch	semi-elektrisch	BNW:STL:ONV
semi-elektrische	semi-elektrisch	BNW:STL:VRB
niet-hormonaal	niet-hormonaal	BNW:STL:ONV
niet-hormonale	niet-hormonaal	BNW:STL:VRB
niet-afgesloten	niet-afgesloten	BNW:STL:ONV
niet-afgesloten	niet-afgesloten	BNW:STL:VRB
leverfibrose	leverfibrose	ZNW:EKV:DE_
leverfibrosen	leverfibrose	ZNW:MRV:DE_
leverfibroses	leverfibrose	ZNW:MRV:DE_
historisch-geografisch	historisch-geografisch	BNW:STL:ONV
historisch-geografische	historisch-geografisch	BNW:STL:VRB
draaivaardig	draaivaardig	BNW:STL:ONV
draaivaardige	draaivaardig	BNW:STL:VRB
boosterdosis	boosterdosis	ZNW:EKV:DE_
boosterdoses	boosterdosis	ZNW:MRV:DE_
boosterdosisje	boosterdosis	ZNW:EKV:VRK:HET
boosterdosisjes	boosterdosis	ZNW:MRV:VRK:DE_
boosterdosissen	boosterdosis	ZNW:MRV:DE_
biocompatibiliteit	biocompatibiliteit	ZNW:EKV:DE_
biocompatibiliteiten	biocompatibiliteit	ZNW:MRV:DE_
atoombrand	atoombrand	ZNW:EKV:DE_
atoombranden	atoombrand	ZNW:MRV:DE_
atoombrandje	atoombrand	ZNW:EKV:VRK:HET
atoombrandjes	atoombrand	ZNW:MRV:VRK:DE_
zoninval	zoninval	ZNW:EKV:DE_
zoninvallen	zoninval	ZNW:MRV:DE_
zoninvalletje	zoninval	ZNW:EKV:VRK:HET
zoninvalletjes	zoninval	ZNW:MRV:VRK:DE_
wortelboorder	wortelboorder	ZNW:EKV:DE_
wortelboordertje	wortelboorder	ZNW:EKV:VRK:HET
wortelboordertjes	wortelboorder	ZNW:MRV:VRK:DE_
volksnationalistisch	volksnationalistisch	BNW:STL:ONV
volksnationalistische	volksnationalistisch	BNW:STL:VRB
spuicapaciteit	spuicapaciteit	ZNW:EKV:DE_
spuicapaciteiten	spuicapaciteit	ZNW:MRV:DE_
spuicapaciteitje	spuicapaciteit	ZNW:EKV:VRK:HET
spuicapaciteitjes	spuicapaciteit	ZNW:MRV:VRK:DE_
ontstaanstijd	ontstaanstijd	ZNW:EKV:DE_
ontstaanstijden	ontstaanstijd	ZNW:MRV:DE_
ontstaanstijdje	ontstaanstijd	ZNW:EKV:VRK:HET
ontstaanstijdjes	ontstaanstijd	ZNW:MRV:VRK:DE_
niet-kwalificerend	niet-kwalificerend	BNW:STL:ONV
niet-kwalificerende	niet-kwalificerend	BNW:STL:VRB
mede-Europeaan	mede-Europeaan	ZNW:EKV:DE_
mede-Europeanen	mede-Europeaan	ZNW:MRV:DE_
ijsbuffer	ijsbuffer	ZNW:EKV:DE_
ijsbuffers	ijsbuffer	ZNW:MRV:DE_
ijsbuffertje	ijsbuffer	ZNW:EKV:VRK:HET
ijsbuffertjes	ijsbuffer	ZNW:MRV:VRK:DE_
gaasachtig	gaasachtig	BNW:STL:ONV
gaasachtige	gaasachtig	BNW:STL:VRB
feeënwereld	feeënwereld	ZNW:EKV:DE_
feeënwerelden	feeënwereld	ZNW:MRV:DE_
feeënwereldje	feeënwereld	ZNW:EKV:VRK:HET
feeënwereldjes	feeënwereld	ZNW:MRV:VRK:DE_
FAGG	FAGG	ZNW:EKV:HET
eventmarketing	eventmarketing	ZNW:EKV:DE_
eenoudervakantie	eenoudervakantie	ZNW:EKV:DE_
eenoudervakantietje	eenoudervakantie	ZNW:EKV:VRK:HET
eenoudervakantietjes	eenoudervakantie	ZNW:MRV:VRK:DE_
booq	booq	ENM:ORG
acrylaatdispersie	acrylaatdispersie	ZNW:EKV:DE_
acrylaatdispersies	acrylaatdispersie	ZNW:MRV:DE_
weerkat	weerkat	ZNW:EKV:DE_
weerkatje	weerkat	ZNW:EKV:VRK:HET
weerkatjes	weerkat	ZNW:MRV:VRK:DE_
weerkatten	weerkat	ZNW:MRV:DE_
vijfbanenstelsel	vijfbanenstelsel	ZNW:EKV:HET
vijfbanenstelsels	vijfbanenstelsel	ZNW:MRV:DE_
vijfbanenstelseltje	vijfbanenstelsel	ZNW:EKV:VRK:HET
vijfbanenstelseltjes	vijfbanenstelsel	ZNW:MRV:VRK:DE_
turboliquidatie	turboliquidatie	ZNW:EKV:DE_
turboliquidaties	turboliquidatie	ZNW:MRV:DE_
turboliquidatietje	turboliquidatie	ZNW:EKV:VRK:HET
turboliquidatietjes	turboliquidatie	ZNW:MRV:VRK:DE_
stikstofbindend	stikstofbindend	BNW:STL:ONV
stikstofbindende	stikstofbindend	BNW:STL:VRB
schadebrengend	schadebrengend	BNW:STL:ONV
schadebrengende	schadebrengend	BNW:STL:VRB
naaitafel	naaitafel	ZNW:EKV:DE_
naaitafels	naaitafel	ZNW:MRV:DE_
naaitafeltje	naaitafel	ZNW:EKV:VRK:HET
naaitafeltjes	naaitafel	ZNW:MRV:VRK:DE_
insulineresistent	insulineresistent	BNW:STL:ONV
insulineresistente	insulineresistent	BNW:STL:VRB
geelharig	geelharig	BNW:STL:ONV
geelharige	geelharig	BNW:STL:VRB
eiwitverrijkt	eiwitverrijkt	BNW:STL:ONV
eiwitverrijkte	eiwitverrijkt	BNW:STL:VRB
dagverlichting	dagverlichting	ZNW:EKV:DE_
dagverlichtingen	dagverlichting	ZNW:MRV:DE_
dagverlichtinkje	dagverlichting	ZNW:EKV:VRK:HET
dagverlichtinkjes	dagverlichting	ZNW:MRV:VRK:DE_
cryptomarkt	cryptomarkt	ZNW:EKV:DE_
cryptomarkten	cryptomarkt	ZNW:MRV:DE_
cryptomarktje	cryptomarkt	ZNW:EKV:VRK:HET
cryptomarktjes	cryptomarkt	ZNW:MRV:VRK:DE_
blowerdoortest	blowerdoortest	ZNW:EKV:DE_
blowerdoortesten	blowerdoortest	ZNW:MRV:DE_
blowerdoortestje	blowerdoortest	ZNW:EKV:VRK:HET
blowerdoortestjes	blowerdoortest	ZNW:MRV:VRK:DE_
blowerdoortests	blowerdoortest	ZNW:MRV:DE_
vliegaggregaat	vliegaggregaat	ZNW:EKV:HET
vliegaggregaatje	vliegaggregaat	ZNW:EKV:VRK:HET
vliegaggregaatjes	vliegaggregaat	ZNW:MRV:VRK:DE_
vliegaggregaten	vliegaggregaat	ZNW:MRV:DE_
verstoffelijking	verstoffelijking	ZNW:EKV:DE_
tweedegrader	tweedegrader	ZNW:EKV:DE_
tweedegraders	tweedegrader	ZNW:MRV:DE_
standmixer	standmixer	ZNW:EKV:DE_
standmixers	standmixer	ZNW:MRV:DE_
standmixertje	standmixer	ZNW:EKV:VRK:HET
standmixertjes	standmixer	ZNW:MRV:VRK:DE_
heroal	heroal	ENM:ORG
wederindiensttredingsvoorwaarde	wederindiensttredingsvoorwaarde	ZNW:EKV:DE_
wederindiensttredingsvoorwaarden	wederindiensttredingsvoorwaarde	ZNW:MRV:DE_
vleeskalverhouderij	vleeskalverhouderij	ZNW:EKV:DE_
vleeskalverhouderijen	vleeskalverhouderij	ZNW:MRV:DE_
veteranenpas	veteranenpas	ZNW:EKV:DE_
veteranenpasje	veteranenpas	ZNW:EKV:VRK:HET
veteranenpasjes	veteranenpas	ZNW:MRV:VRK:DE_
veteranenpassen	veteranenpas	ZNW:MRV:DE_
transhumanist	transhumanist	ZNW:EKV:DE_
transhumanisten	transhumanist	ZNW:MRV:DE_
subpersoonlijkheid	subpersoonlijkheid	ZNW:EKV:DE_
subpersoonlijkheden	subpersoonlijkheid	ZNW:MRV:DE_
subpersoonlijkheidje	subpersoonlijkheid	ZNW:EKV:VRK:HET
subpersoonlijkheidjes	subpersoonlijkheid	ZNW:MRV:VRK:DE_
rijklaarmaakkosten	rijklaarmaakkosten	ZNW:MRV:DE_
oogstschip	oogstschip	ZNW:EKV:HET
oogstscheepje	oogstschip	ZNW:EKV:VRK:HET
oogstscheepjes	oogstschip	ZNW:MRV:VRK:DE_
oogstschepen	oogstschip	ZNW:MRV:DE_
niet-professional	niet-professional	ZNW:EKV:DE_
niet-professionals	niet-professional	ZNW:MRV:DE_
kopopleiding	kopopleiding	ZNW:EKV:DE_
kopopleidingen	kopopleiding	ZNW:MRV:DE_
kopopleidinkje	kopopleiding	ZNW:EKV:VRK:HET
kopopleidinkjes	kopopleiding	ZNW:MRV:VRK:DE_
hyperradiobericht	hyperradiobericht	ZNW:EKV:HET
hyperradioberichten	hyperradiobericht	ZNW:MRV:DE_
hyperradioberichtje	hyperradiobericht	ZNW:EKV:VRK:HET
hyperradioberichtjes	hyperradiobericht	ZNW:MRV:VRK:DE_
herclassificatie	herclassificatie	ZNW:EKV:DE_
herclassificaties	herclassificatie	ZNW:MRV:DE_
drukhelm	drukhelm	ZNW:EKV:DE_
drukhelmen	drukhelm	ZNW:MRV:DE_
drukhelmpje	drukhelm	ZNW:EKV:VRK:HET
drukhelmpjes	drukhelm	ZNW:MRV:VRK:DE_
detailhandelstructuur	detailhandelstructuur	ZNW:EKV:DE_
detailhandelstructuren	detailhandelstructuur	ZNW:MRV:DE_
detailhandelstructuurtje	detailhandelstructuur	ZNW:EKV:VRK:HET
detailhandelstructuurtjes	detailhandelstructuur	ZNW:MRV:VRK:DE_
weertoren	weertoren	ZNW:EKV:DE_
weertorens	weertoren	ZNW:MRV:DE_
weertorentje	weertoren	ZNW:EKV:VRK:HET
weertorentjes	weertoren	ZNW:MRV:VRK:DE_
vijfdimensionaal	vijfdimensionaal	BNW:STL:ONV
vijfdimensionale	vijfdimensionaal	BNW:STL:VRB
remineralisatie	remineralisatie	ZNW:EKV:DE_
operatiejas	operatiejas	ZNW:EKV:DE_
operatiejasje	operatiejas	ZNW:EKV:VRK:HET
operatiejasjes	operatiejas	ZNW:MRV:VRK:DE_
dagkoekoeksbloem	dagkoekoeksbloem	ZNW:EKV:DE_
dagkoekoeksbloemen	dagkoekoeksbloem	ZNW:MRV:DE_
dagkoekoeksbloemetje	dagkoekoeksbloem	ZNW:EKV:VRK:HET
dagkoekoeksbloemetjes	dagkoekoeksbloem	ZNW:MRV:VRK:DE_
dagkoekoeksbloempje	dagkoekoeksbloem	ZNW:EKV:VRK:HET
dagkoekoeksbloempjes	dagkoekoeksbloem	ZNW:MRV:VRK:DE_
celverwijzing	celverwijzing	ZNW:EKV:DE_
celverwijzingen	celverwijzing	ZNW:MRV:DE_
celverwijzinkje	celverwijzing	ZNW:EKV:VRK:HET
celverwijzinkjes	celverwijzing	ZNW:MRV:VRK:DE_
vleesvarkenshouderij	vleesvarkenshouderij	ZNW:EKV:DE_
vleesvarkenshouderijen	vleesvarkenshouderij	ZNW:MRV:DE_
supersymmetrisch	supersymmetrisch	BNW:STL:ONV
supersymmetrische	supersymmetrisch	BNW:STL:VRB
niet-uitgevoerd	niet-uitgevoerd	BNW:STL:ONV
niet-uitgevoerde	niet-uitgevoerd	BNW:STL:VRB
niet-handelstransactie	niet-handelstransactie	ZNW:EKV:DE_
niet-handelstransacties	niet-handelstransactie	ZNW:MRV:DE_
niet-handelstransactietje	niet-handelstransactie	ZNW:EKV:VRK:HET
niet-handelstransactietjes	niet-handelstransactie	ZNW:MRV:VRK:DE_
lichtset	lichtset	ZNW:EKV:DE_
lichtsetje	lichtset	ZNW:EKV:VRK:HET
lichtsetjes	lichtset	ZNW:MRV:VRK:DE_
lichtsets	lichtset	ZNW:MRV:DE_
kenkleur	kenkleur	ZNW:EKV:DE_
kenkleuren	kenkleur	ZNW:MRV:DE_
kenkleurtje	kenkleur	ZNW:EKV:VRK:HET
kenkleurtjes	kenkleur	ZNW:MRV:VRK:DE_
hypersensitiviteit	hypersensitiviteit	ZNW:EKV:DE_
hypersensitiviteiten	hypersensitiviteit	ZNW:MRV:DE_
huurhernieuwing	huurhernieuwing	ZNW:EKV:DE_
huurhernieuwingen	huurhernieuwing	ZNW:MRV:DE_
fysisch-geografisch	fysisch-geografisch	BNW:STL:ONV
fysisch-geografische	fysisch-geografisch	BNW:STL:VRB
bloedveegje	bloedveeg	ZNW:EKV:VRK:HET
bloedveegjes	bloedveeg	ZNW:MRV:VRK:DE_
bloedvegen	bloedveeg	ZNW:MRV:DE_
overnight	overnight	BNW:STL:VRB
thumbnails	thumbnail	ZNW:MRV:DE_
downhill	downhill	BNW:STL:VRB
lifecycles	lifecycle	ZNW:MRV:DE_
camerlengo's	camerlengo	ZNW:MRV:DE_
turnkey	turnkey	BNW:STL:VRB
scoots	scoot	ZNW:MRV:DE_
televisie-interviewsters	televisie-interviewster	ZNW:MRV:DE_
lose-losesituaties	lose-losesituatie	ZNW:MRV:DE_
lose-losesituatietje	lose-losesituatie	ZNW:EKV:VRK:HET
lose-losesituatietjes	lose-losesituatie	ZNW:MRV:VRK:DE_
lay-outers	lay-outer	ZNW:MRV:DE_
onfrisheid	onfrisheid	ZNW:EKV:DE_
onfrisheden	onfrisheid	ZNW:MRV:DE_
lanceersoftware	lanceersoftware	ZNW:EKV:DE_
Cortes	Cortes	ZNW:EKV:DE_
fasciae	fascia	ZNW:MRV:DE_
fasciën	fascia	ZNW:MRV:DE_
septa	septum	ZNW:MRV:DE_
afakie	afakie	ZNW:EKV:DE_
nozzles	nozzle	ZNW:MRV:DE_
struggles	struggle	ZNW:MRV:DE_
uitschuifbureau	uitschuifbureau	ZNW:EKV:HET
uitschuifbureaus	uitschuifbureau	ZNW:MRV:DE_
uitschuifbureautje	uitschuifbureau	ZNW:EKV:VRK:HET
uitschuifbureautjes	uitschuifbureau	ZNW:MRV:VRK:DE_
Borremans	Borremans	ENM:PER:LST
Peeters	Peeters	ENM:PER:LST
Janssens	Janssens	ENM:PER:LST
Jacobs	Jacobs	ENM:PER:LST
Mertens	Mertens	ENM:PER:LST
Willems	Willems	ENM:PER:LST
Claes	Claes	ENM:PER:LST
Goossens	Goossens	ENM:PER:LST
Vermeulen	Vermeulen	ENM:PER:LST
Pauwels	Pauwels	ENM:PER:LST
Dubois	Dubois	ENM:PER:LST
Hermans	Hermans	ENM:PER:LST
Aerts	Aerts	ENM:PER:LST
Michiels	Michiels	ENM:PER:LST
Lambert	Lambert	ENM:PER:LST
Martens	Martens	ENM:PER:LST
Smets	Smets	ENM:PER:LST
Claeys	Claeys	ENM:PER:LST
Desmet	Desmet	ENM:PER:LST
Dupont	Dupont	ENM:PER:LST
Janssen	Janssen	ENM:PER:LST
Hendrickx	Hendrickx	ENM:PER:LST
Stevens	Stevens	ENM:PER:LST
Devos	Devos	ENM:PER:LST
Martin	Martin	ENM:PER:LST
Lemmens	Lemmens	ENM:PER:LST
Segers	Segers	ENM:PER:LST
Coppens	Coppens	ENM:PER:LST
Diallo	Diallo	ENM:PER:LST
Simon	Simon	ENM:PER:LST
Leroy	Leroy	ENM:PER:LST
Dumont	Dumont	ENM:PER:LST
Wauters	Wauters	ENM:PER:LST
François	François	ENM:PER:LST
Verhoeven	Verhoeven	ENM:PER:LST
Leclercq	Leclercq	ENM:PER:LST
Cools	Cools	ENM:PER:LST
Laurent	Laurent	ENM:PER:LST
Smet	Smet	ENM:PER:LST
Declercq	Declercq	ENM:PER:LST
Denis	Denis	ENM:PER:LST
Thys	Thys	ENM:PER:LST
Thomas	Thomas	ENM:PER:LST
Renard	Renard	ENM:PER:LST
Timmermans	Timmermans	ENM:PER:LST
Baert	Baert	ENM:PER:LST
Lejeune	Lejeune	ENM:PER:LST
Vandenberghe	Vandenberghe	ENM:PER:LST
Lenaerts	Lenaerts	ENM:PER:LST
Verheyen	Verheyen	ENM:PER:LST
Lauwers	Lauwers	ENM:PER:LST
Gérard	Gérard	ENM:PER:LST
Lambrechts	Lambrechts	ENM:PER:LST
Petit	Petit	ENM:PER:LST
Lemaire	Lemaire	ENM:PER:LST
Bogaert	Bogaert	ENM:PER:LST
Geerts	Geerts	ENM:PER:LST
Mathieu	Mathieu	ENM:PER:LST
Verbeke	Verbeke	ENM:PER:LST
Cornelis	Cornelis	ENM:PER:LST
Bauwens	Bauwens	ENM:PER:LST
Christiaens	Christiaens	ENM:PER:LST
Moens	Moens	ENM:PER:LST
Charlier	Charlier	ENM:PER:LST
Vermeiren	Vermeiren	ENM:PER:LST
Bosmans	Bosmans	ENM:PER:LST
Verlinden	Verlinden	ENM:PER:LST
Wuyts	Wuyts	ENM:PER:LST
Verschueren	Verschueren	ENM:PER:LST
Michel	Michel	ENM:PER:LST
Bertrand	Bertrand	ENM:PER:LST
Jansen	Jansen	ENM:PER:LST
Noël	Noël	ENM:PER:LST
Deprez	Deprez	ENM:PER:LST
Fontaine	Fontaine	ENM:PER:LST
Carlier	Carlier	ENM:PER:LST
Bogaerts	Bogaerts	ENM:PER:LST
Simons	Simons	ENM:PER:LST
Beckers	Beckers	ENM:PER:LST
Adam	Adam	ENM:PER:LST
Claessens	Claessens	ENM:PER:LST
Heylen	Heylen	ENM:PER:LST
Evrard	Evrard	ENM:PER:LST
Pieters	Pieters	ENM:PER:LST
Goethals	Goethals	ENM:PER:LST
Bernard	Bernard	ENM:PER:LST
Lefebvre	Lefebvre	ENM:PER:LST
Lievens	Lievens	ENM:PER:LST
Legrand	Legrand	ENM:PER:LST
Thijs	Thijs	ENM:PER:LST
Marchal	Marchal	ENM:PER:LST
Ceulemans	Ceulemans	ENM:PER:LST
Vandamme	Vandamme	ENM:PER:LST
Callens	Callens	ENM:PER:LST
Mahieu	Mahieu	ENM:PER:LST
Robert	Robert	ENM:PER:LST
Bah	Bah	ENM:PER:LST
Verhaegen	Verhaegen	ENM:PER:LST
Dierckx	Dierckx	ENM:PER:LST
Collard	Collard	ENM:PER:LST
Verhelst	Verhelst	ENM:PER:LST
Roels	Roels	ENM:PER:LST
Matthys	Matthys	ENM:PER:LST
Nijs	Nijs	ENM:PER:LST
Moreau	Moreau	ENM:PER:LST
Raes	Raes	ENM:PER:LST
Gielen	Gielen	ENM:PER:LST
Singh	Singh	ENM:PER:LST
Delvaux	Delvaux	ENM:PER:LST
Yilmaz	Yilmaz	ENM:PER:LST
Vercammen	Vercammen	ENM:PER:LST
Nys	Nys	ENM:PER:LST
Verbruggen	Verbruggen	ENM:PER:LST
Thiry	Thiry	ENM:PER:LST
Vandevelde	Vandevelde	ENM:PER:LST
Cuypers	Cuypers	ENM:PER:LST
Luyten	Luyten	ENM:PER:LST
Vervoort	Vervoort	ENM:PER:LST
Vanneste	Vanneste	ENM:PER:LST
Somers	Somers	ENM:PER:LST
Vercruysse	Vercruysse	ENM:PER:LST
Daems	Daems	ENM:PER:LST
Verdonck	Verdonck	ENM:PER:LST
Parmentier	Parmentier	ENM:PER:LST
André	André	ENM:PER:LST
Andries	Andries	ENM:PER:LST
Vercauteren	Vercauteren	ENM:PER:LST
Jacques	Jacques	ENM:PER:LST
Mortier	Mortier	ENM:PER:LST
Swinnen	Swinnen	ENM:PER:LST
Huysmans	Huysmans	ENM:PER:LST
Henry	Henry	ENM:PER:LST
Verhulst	Verhulst	ENM:PER:LST
Vandewalle	Vandewalle	ENM:PER:LST
Smeets	Smeets	ENM:PER:LST
Claus	Claus	ENM:PER:LST
Declerck	Declerck	ENM:PER:LST
Herman	Herman	ENM:PER:LST
Leemans	Leemans	ENM:PER:LST
Vanhove	Vanhove	ENM:PER:LST
Baeyens	Baeyens	ENM:PER:LST
Rousseau	Rousseau	ENM:PER:LST
Verbeeck	Verbeeck	ENM:PER:LST
Bastin	Bastin	ENM:PER:LST
Léonard	Léonard	ENM:PER:LST
Dewulf	Dewulf	ENM:PER:LST
Gillet	Gillet	ENM:PER:LST
Louis	Louis	ENM:PER:LST
Guillaume	Guillaume	ENM:PER:LST
Deckers	Deckers	ENM:PER:LST
Servais	Servais	ENM:PER:LST
David	David	ENM:PER:LST
Geens	Geens	ENM:PER:LST
Smits	Smits	ENM:PER:LST
Vanhoutte	Vanhoutte	ENM:PER:LST
Meert	Meert	ENM:PER:LST
Descamps	Descamps	ENM:PER:LST
Hubert	Hubert	ENM:PER:LST
Dierickx	Dierickx	ENM:PER:LST
Jans	Jans	ENM:PER:LST
Coenen	Coenen	ENM:PER:LST
Verheyden	Verheyden	ENM:PER:LST
Huybrechts	Huybrechts	ENM:PER:LST
Moons	Moons	ENM:PER:LST
Goffin	Goffin	ENM:PER:LST
Engelen	Engelen	ENM:PER:LST
Toussaint	Toussaint	ENM:PER:LST
Lebrun	Lebrun	ENM:PER:LST
Collin	Collin	ENM:PER:LST
Meeus	Meeus	ENM:PER:LST
Goris	Goris	ENM:PER:LST
Sterckx	Sterckx	ENM:PER:LST
Antoine	Antoine	ENM:PER:LST
Maertens	Maertens	ENM:PER:LST
Vandenbussche	Vandenbussche	ENM:PER:LST
Peters	Peters	ENM:PER:LST
Vandendriessche	Vandendriessche	ENM:PER:LST
Schepers	Schepers	ENM:PER:LST
Engels	Engels	ENM:PER:LST
Houben	Houben	ENM:PER:LST
Reynders	Reynders	ENM:PER:LST
Lecomte	Lecomte	ENM:PER:LST
Bekaert	Bekaert	ENM:PER:LST
Dhondt	Dhondt	ENM:PER:LST
Grégoire	Grégoire	ENM:PER:LST
Temmerman	Temmerman	ENM:PER:LST
Vaes	Vaes	ENM:PER:LST
Barry	Barry	ENM:PER:LST
Eeckhout	Eeckhout	ENM:PER:LST
Schmitz	Schmitz	ENM:PER:LST
Cornet	Cornet	ENM:PER:LST
Luyckx	Luyckx	ENM:PER:LST
Vermeire	Vermeire	ENM:PER:LST
Remy	Remy	ENM:PER:LST
Mariën	Mariën	ENM:PER:LST
Huyghe	Huyghe	ENM:PER:LST
Maréchal	Maréchal	ENM:PER:LST
Dujardin	Dujardin	ENM:PER:LST
Michaux	Michaux	ENM:PER:LST
Joris	Joris	ENM:PER:LST
Boonen	Boonen	ENM:PER:LST
Libert	Libert	ENM:PER:LST
Poncelet	Poncelet	ENM:PER:LST
Cuvelier	Cuvelier	ENM:PER:LST
Lambrecht	Lambrecht	ENM:PER:LST
Nuyts	Nuyts	ENM:PER:LST
Dewaele	Dewaele	ENM:PER:LST
Debruyne	Debruyne	ENM:PER:LST
Heymans	Heymans	ENM:PER:LST
Decock	Decock	ENM:PER:LST
Bracke	Bracke	ENM:PER:LST
Lefèvre	Lefèvre	ENM:PER:LST
Bollen	Bollen	ENM:PER:LST
Lacroix	Lacroix	ENM:PER:LST
Massart	Massart	ENM:PER:LST
Decoster	Decoster	ENM:PER:LST
Callewaert	Callewaert	ENM:PER:LST
Boone	Boone	ENM:PER:LST
Blomme	Blomme	ENM:PER:LST
Baeten	Baeten	ENM:PER:LST
Ooms	Ooms	ENM:PER:LST
Gilson	Gilson	ENM:PER:LST
Helsen	Helsen	ENM:PER:LST
Meunier	Meunier	ENM:PER:LST
Moerman	Moerman	ENM:PER:LST
Piette	Piette	ENM:PER:LST
Desmedt	Desmedt	ENM:PER:LST
Everaert	Everaert	ENM:PER:LST
Driesen	Driesen	ENM:PER:LST
Vincent	Vincent	ENM:PER:LST
Torfs	Torfs	ENM:PER:LST
Bonte	Bonte	ENM:PER:LST
Schepens	Schepens	ENM:PER:LST
Jacob	Jacob	ENM:PER:LST
Vranken	Vranken	ENM:PER:LST
Govaerts	Govaerts	ENM:PER:LST
Vanderstraeten	Vanderstraeten	ENM:PER:LST
Leys	Leys	ENM:PER:LST
Tanghe	Tanghe	ENM:PER:LST
Vrancken	Vrancken	ENM:PER:LST
Delhaye	Delhaye	ENM:PER:LST
Piron	Piron	ENM:PER:LST
Bourgeois	Bourgeois	ENM:PER:LST
Jonckheere	Jonckheere	ENM:PER:LST
Merckx	Merckx	ENM:PER:LST
Vandekerckhove	Vandekerckhove	ENM:PER:LST
Georges	Georges	ENM:PER:LST
Verbist	Verbist	ENM:PER:LST
Hardy	Hardy	ENM:PER:LST
Roland	Roland	ENM:PER:LST
Nguyen	Nguyen	ENM:PER:LST
röntgen	röntgen	ZNW:EKV:DE_
NOC	NOC	ZNW:EKV:HET
CVZ	CVZ	ZNW:EKV:HET
Eadulf	Eadulf	ENM:PER:FST
LJN	LJN	ZNW:EKV:HET
Wft	Wft	ZNW:EKV:DE_
Garion	Garion	ENM:PER:FST
DSB	DSB	ZNW:EKV:DE_
IVN	IVN	ZNW:EKV:HET
ACV	ACV	ZNW:EKV:HET
Zvw	Zvw	ZNW:EKV:DE_
GLB	GLB	ZNW:EKV:HET
COC	COC	ZNW:EKV:HET
CJIB	CJIB	ZNW:EKV:HET
RWS	RWS	ENM:ORG
AMG	AMG	ENM:ORG
WRR	WRR	ZNW:EKV:DE_
Silvere	Silvere	ENM:PER:FST
CPN	CPN	ZNW:EKV:DE_
VUB	VUB	ZNW:EKV:DE_
BVD	BVD	ZNW:EKV:DE_
HvJ	HvJ	ZNW:EKV:HET
Wbp	Wbp	ZNW:EKV:DE_
Vpb	Vpb	ZNW:EKV
CAK	CAK	ZNW:EKV:HET
Temeraire	Temeraire	ENM:PER:FST
NFI	NFI	ZNW:EKV:HET
BOVAG	BOVAG	ZNW:EKV:DE_
Haplo	Haplo	ENM:PER:FST
WGA	WGA	ZNW:EKV:DE_
BRP	BRP	ZNW:EKV:DE_
ILT	ILT	ZNW:EKV:DE_
ADR	ADR	ZNW:EKV:DE_
KWPN	KWPN	ZNW:EKV
BNR	BNR	ENM:ORG
Adriaen	Adriaen	ENM:PER:FST
VDL	VDL	ENM:ORG
WOR	WOR	ZNW:EKV:DE_
KNAW	KNAW	ZNW:EKV:DE_
Flinx	Flinx	ENM:PER:FST
CVP	CVP	ZNW:EKV:DE_
Veritas	Veritas	ENM:ORG
ECN	ECN	ZNW:EKV:HET
GPV	GPV	ZNW:EKV:HET
CJG	CJG	ZNW:EKV:HET
Schauvliege	Schauvliege	ENM:PER:LST
RPF	RPF	ZNW:EKV:DE_
PKB	PKB	ZNW:EKV:DE_
epc	epc	ZNW:EKV:DE_
RvA	RvA	ZNW:EKV:DE_
Ducati	Ducati	ENM:ORG
LSP	LSP	ZNW:EKV:HET
KVP	KVP	ZNW:EKV:DE_
VwEU	VwEU	ZNW:EKV:HET
KBVB	KBVB	ZNW:EKV:DE_
Cascal	Cascal	ENM:PER:LST
Kabila	Kabila	ENM:PER:LST
WWE	WWE	ENM:ORG
PwC	PwC	ENM:ORG
muisbever	muisbever	ZNW:EKV:DE_
muisbevers	muisbever	ZNW:MRV:DE_
muisbevertje	muisbever	ZNW:EKV:VRK:HET
muisbevertjes	muisbever	ZNW:MRV:VRK:DE_
RVV	RVV	ENM:ORG
Jommeke	Jommeke	ENM:PER:FST
CBG	CBG	ZNW:EKV:HET
Forza	Forza	ENM:ORG
Lightroom	Lightroom	ENM:PRD
NVAO	NVAO	ZNW:EKV:DE_
NVB	NVB	ZNW:EKV:DE_
Lil	Lil	ENM:PER:FST
Dodar	Dodar	ENM:PER:FST
ESF	ESF	ZNW:EKV:HET
Sterzon	Sterzon	ENM:PER:LST
IenM	IenM	ENM:ORG
Tolot	Tolot	ENM:PER:LST
LDD	LDD	ZNW:EKV:DE_
Derec	Derec	ENM:PER:FST
Giordino	Giordino	ENM:PER:FST
Nete	Nete	ENM:PER:FST
NBB	NBB	ZNW:EKV:DE_
VNV	VNV	ZNW:EKV:DE_
ZonMw	ZonMw	ENM:ORG
AMK	AMK	ZNW:EKV:HET
Hagrid	Hagrid	ENM:PER:FST
EFSA	EFSA	ZNW:EKV:DE_
VEB	VEB	ZNW:EKV:DE_
Nevyn	Nevyn	ENM:PER:FST
EMA	EMA	ZNW:EKV:DE_
Rinzwind	Rinzwind	ENM:PER:LST
Rhodry	Rhodry	ENM:PER:FST
Fyra	Fyra	ENM:PER:FST
Tungdil	Tungdil	ENM:PER:LST
WTA	WTA	ZNW:EKV:DE_
OVAM	OVAM	ZNW:EKV:DE_
Jeltsin	Jeltsin	ENM:PER:LST
CSI	CSI	ENM:PER:FST
GoPro	GoPro	ENM:PRD
GTST	GTST	ENM:PRD
VHP	VHP	ZNW:EKV:DE_
CRvB	CRvB	ZNW:EKV:DE_
CHMP	CHMP	ZNW:EKV:DE_
Anciaux	Anciaux	ENM:PER:LST
Lanoye	Lanoye	ENM:PER:LST
HACCP	HACCP	ZNW:EKV:DE_
Ymere	Ymere	ENM:ORG
PADI	PADI	ZNW:EKV:DE_
EMC	EMC	ENM:ORG
WODC	WODC	ZNW:EKV:HET
forex	forex	ZNW:EKV:DE_
Joo	Joo	ENM:PER:FST
Pollifax	Pollifax	ENM:PER:LST
WRC	WRC	ZNW:EKV:DE_
RBC	RBC	ENM:ORG
Cugel	Cugel	ENM:PER:FST
KNMP	KNMP	ZNW:EKV:DE_
LHV	LHV	ZNW:EKV:DE_
GMR	GMR	ZNW:EKV:DE_
Fw	Fw	ZNW:EKV:DE_
LBIO	LBIO	ENM:ORG
Hizkia	Hizkia	ENM:PER:FST
SLO	SLO	ZNW:EKV:DE_
Garp	Garp	ENM:PER:LST
RSZ	RSZ	ZNW:EKV:DE_
Arutha	Arutha	ENM:PER:FST
FARC	FARC	ZNW:EKV:DE_
NVV	NVV	ZNW:EKV:HET
HVC	HVC	ENM:ORG
Tobback	Tobback	ENM:PER:LST
Strukton	Strukton	ENM:ORG
IDF	IDF	ENM:ORG
NSAID	NSAID	ZNW:EKV
NSAID's	NSAID	ZNW:MRV:DE_
DBA	DBA	ZNW:EKV:DE_
Lumia	Lumia	ENM:PRD
Dungen	Dungen	ENM:PER:LST:DEN
GHOR	GHOR	ENM:ORG
Rebecka	Rebecka	ENM:PER:FST
ASN	ASN	ENM:ORG
NBV	NBV	ZNW:EKV:DE_
Enexis	Enexis	ENM:ORG
Malfidus	Malfidus	ENM:PER:LST
Blendle	Blendle	ENM:ORG
Jaric	Jaric	ENM:PER:FST
Ailinn	Ailinn	ENM:PER:FST
Gunnarstranda	Gunnarstranda	ENM:PER:LST
Tengo	Tengo	ENM:PER:FST
EVC	EVC	ENM:ORG
NVJ	NVJ	ENM:ORG
HVV	HVV	ENM:ORG
Camillo	Camillo	ENM:LOC:EIL
