# Postags that are in the binary, but no longer valid, generated from database.
#
# Dot not add entries here, but report them on the forum.
#
bloedveeg	bloedveeg	ZNW:EKV
eigenaarschap	eigenaarschap	ZNW:EKV
gesnedene	gesnedene	ZNW:EKV
gesnedenen	gesnedene	ZNW:MRV:DE_
heenkomen	heenkomen	ZNW:EKV:HET
niet-gemotorisere	niet-gemotoriseerd	BNW:STL:VRB
nomens	nomen	ZNW:MRV:DE_
nomentje	nomen	ZNW:EKV:VRK:HET
nomentjes	nomen	ZNW:MRV:VRK:DE_
slachtafval	slachtafval	ZNW:EKV
geotextiel	geotextiel	ZNW:EKV
hartoverslag	hartoverslag	ZNW:EKV:HET
samenvattingstaken	samenvattingstaken	ZNW:MRV:DE_
tandemassen	tandemassen	ZNW:MRV:DE_
operatiejassen	operatiejassen	ZNW:MRV:DE_
servicepassen	servicepassen	ZNW:MRV:DE_
zendingsdagen	zendingsdagen	ZNW:MRV:DE_
moeraskatten	moeraskatten	ZNW:MRV:DE_
boerkool	boerkool	ZNW:EKV:DE_
kansspelwetten	kansspelwetten	ZNW:MRV:DE_
borenkool	borenkool	ZNW:EKV:DE_
Herderscheê	Herderscheê	ENM:PER:LST:NIX
Herderscheês	Herderscheê	ENM:BEZ
eigenaarschapje	eigenaarschap	ZNW:EKV:VRK:HET
eigenaarschapjes	eigenaarschap	ZNW:MRV:VRK:DE_
eigenaarschappen	eigenaarschap	ZNW:MRV:DE_
Federal	Federal	ENM:LOC:PTS
wortelboorders	wortelboorders	ZNW:MRV:DE_
