# added postag entries
#-------------------------------------------------------------------------------
# Do not add words here, but report them to languagetool@taaltik.nl
#-------------------------------------------------------------------------------
kraplap	kraplap	ZNW:EKV:DE_
inwerkingtredingsdatums	inwerkingtredingsdatum	ZNW:MRV:DE_
planking	planking	ZNW:EKV:HET
meldingplichtig	meldingplichtig	BNW:STL:ONV
meldingplichtige	meldingplichtige	ZNW:EKV:DE_
klasoverschrijdend	klasoverschrijdend	BNW:STL:ONV
keukentaal	keukentaal	ZNW:EKV:DE_
klasoverschrijdende	klasoverschrijdend	BNW:STL:VRB
keukentaaltje	keukentaal	ZNW:EKV:VRK:HET
kekererwt	kekererwt	ZNW:EKV:DE_
kekererwten	kekererwt	ZNW:MRV:DE_
kattengejammer	kattengejammer	ZNW:EKV:HET
hogesterktestaal	hogesterktestaal	ZNW:EKV:HET
hogesterktestalen	hogesterktestaal	ZNW:MRV:DE_
grotbiken	grotbiken	WKW:INF:ZNW:HET
figuurzaagmachine	figuurzaagmachine	ZNW:EKV:DE_
figuurzaagmachines	figuurzaagmachine	ZNW:MRV:DE_
gordelspansysteem	gordelspansysteem	ZNW:EKV:HET
grondluiaard	grondluiaard	ZNW:EKV:DE_
grondluiaarden	grondluiaard	ZNW:MRV:DE_
grondluiaards	grondluiaard	ZNW:MRV:DE_
gravenstand	gravenstand	ZNW:EKV:DE_
glycogeenreserve	glycogeenreserve	ZNW:EKV:DE_
glycogeenreserves	glycogeenreserve	ZNW:MRV:DE_
gelatinelaag	gelatinelaag	ZNW:EKV:DE_
gelatinelaagje	gelatinelaag	ZNW:EKV:VRK:HET
gelatinelagen	gelatinelaag	ZNW:MRV:DE_
gangbeeldanalyse	gangbeeldanalyse	ZNW:EKV:DE_
gangbeeldanalysen	gangbeeldanalyse	ZNW:MRV:DE_
gangbeeldanalyses	gangbeeldanalyse	ZNW:MRV:DE_
foodcorner	foodcorner	ZNW:EKV:DE_
foodcorners	foodcorner	ZNW:MRV:DE_
fokwieksysteem	fokwieksysteem	ZNW:EKV:HET
familiekarma	familiekarma	ZNW:EKV:HET
fagentherapie	fagentherapie	ZNW:EKV:DE_
fagentherapieën	fagentherapie	ZNW:MRV:DE_
erewoordverklaring	erewoordverklaring	ZNW:EKV:DE_
erewoordverklaringen	erewoordverklaring	ZNW:MRV:DE_
dwarsdrukcompensatie	dwarsdrukcompensatie	ZNW:EKV:DE_
driemastbark	driemastbark	ZNW:EKV:DE_
driemastbarkje	driemastbark	ZNW:EKV:VRK:HET
dorpelverbreder	dorpelverbreder	ZNW:EKV:DE_
dorpelverbreders	dorpelverbreder	ZNW:MRV:DE_
doorstuuradres	doorstuuradres	ZNW:EKV:HET
doorstuuradressen	doorstuuradres	ZNW:MRV:DE_
dogmaverklaring	dogmaverklaring	ZNW:EKV:DE_
dogmaverklaringen	dogmaverklaring	ZNW:MRV:DE_
doelwitcel	doelwitcel	ZNW:EKV:DE_
doelwitcellen	doelwitcel	ZNW:MRV:DE_
disculpatiemogelijkheid	disculpatiemogelijkheid	ZNW:EKV:DE_
disculpatiemogelijkheden	disculpatiemogelijkheid	ZNW:MRV:DE_
deerniswaardige	deerniswaardig	BNW:STL:VRB
deerniswaardigsten	deerniswaardig	BNW:OVR:MRV:DE_
deerniswaardiger	deerniswaardig	BNW:VGR:ONV
deerniswaardigen	deerniswaardig	BNW:STL:MRV:DE_
allerdeerniswaardigste	deerniswaardig	BNW:ALR:VRB
darmresectie	darmresectie	ZNW:EKV:DE_
darmresecties	darmresectie	ZNW:MRV:DE_
dakbedekkingsysteem	dakbedekkingsysteem	ZNW:EKV:HET
dakbedekkingsystemen	dakbedekkingsysteem	ZNW:MRV:DE_
daglonershuis	daglonershuis	ZNW:EKV:HET
daglonershuisje	daglonershuis	ZNW:EKV:VRK:HET
daglonershuisjes	daglonershuis	ZNW:MRV:VRK:DE_
daglonershuizen	daglonershuis	ZNW:MRV:DE_
cryptosysteem	cryptosysteem	ZNW:EKV:HET
cryptosystemen	cryptosysteem	ZNW:MRV:DE_
conceptdagvaarding	conceptdagvaarding	ZNW:EKV:DE_
conceptdagvaardingen	conceptdagvaarding	ZNW:MRV:DE_
computerlinguïstiek	computerlinguïstiek	ZNW:EKV:DE_
clubtopscoorder	clubtopscoorder	ZNW:EKV:DE_
chesterfieldbank	chesterfieldbank	ZNW:EKV:DE_
chesterfieldbanken	chesterfieldbank	ZNW:MRV:DE_
chesterfieldbankje	chesterfieldbank	ZNW:EKV:VRK:HET
charterkamer	charterkamer	ZNW:EKV:DE_
charterkamers	charterkamer	ZNW:MRV:DE_
calendulazalf	calendulazalf	ZNW:EKV:DE_
boekhandelaarster	boekhandelaarster	ZNW:EKV:DE_
boekhandelaarsters	boekhandelaarster	ZNW:MRV:DE_
blokhutprofiel	blokhutprofiel	ZNW:EKV:HET
blokhutprofielen	blokhutprofiel	ZNW:MRV:DE_
blauwsatijnen	blauwsatijnen	BNW:STF
blankgeschuurd	blankgeschuurd	BNW:STL:ONV
blankgeschuurde	blankgeschuurd	BNW:STL:VRB
bladgroenloos	bladgroenloos	BNW:STL:ONV
bladgroenloze	bladgroenloos	BNW:STL:VRB
bezoekersonthaal	bezoekersonthaal	ZNW:EKV:HET
beautyvlogger	beautyvlogger	ZNW:EKV:DE_
beautyvloggers	beautyvlogger	ZNW:MRV:DE_
basculekelder	basculekelder	ZNW:EKV:DE_
basculekelders	basculekelder	ZNW:MRV:DE_
atoomonderzeeboot	atoomonderzeeboot	ZNW:EKV:DE_
atoomonderzeeboten	atoomonderzeeboot	ZNW:MRV:DE_
antipsychotisch	antipsychotisch	BNW:STL:ONV
antipsychotische	antipsychotisch	BNW:STL:VRB
afzinkkelder	afzinkkelder	ZNW:EKV:DE_
afzinkkelders	afzinkkelder	ZNW:MRV:DE_
afvalzakhouder	afvalzakhouder	ZNW:EKV:DE_
afvalzakhouders	afvalzakhouder	ZNW:MRV:DE_
afbindknoop	afbindknoop	ZNW:EKV:DE_
afbindknoopje	afbindknoop	ZNW:EKV:VRK:HET
afbindknopen	afbindknoop	ZNW:MRV:DE_
abdijruïne	abdijruïne	ZNW:EKV:DE_
abdijruïnes	abdijruïne	ZNW:MRV:DE_
zwaartekrachtsversnelling	zwaartekrachtsversnelling	ZNW:EKV:DE_
zwaartekrachtsversnellingen	zwaartekrachtsversnelling	ZNW:MRV:DE_
zuurdesemstarter	zuurdesemstarter	ZNW:EKV:DE_
zuurdesemstarters	zuurdesemstarter	ZNW:MRV:DE_
zijwindgevoeligheid	zijwindgevoeligheid	ZNW:EKV:DE_
zelffelicitatie	zelffelicitatie	ZNW:EKV:DE_
zelffelicitaties	zelffelicitatie	ZNW:MRV:DE_
zeefdrukgaas	zeefdrukgaas	ZNW:EKV:HET
zeefdrukgazen	zeefdrukgaas	ZNW:MRV:DE_
wolfsvacht	wolfsvacht	ZNW:EKV:DE_
wolfsvachten	wolfsvacht	ZNW:MRV:DE_
wildragout	wildragout	ZNW:EKV:DE_
wildragouts	wildragout	ZNW:MRV:DE_
voorzieningenpeil	voorzieningenpeil	ZNW:EKV:HET
volkorentoast	volkorentoast	ZNW:EKV:DE_
volkorentoastje	volkorentoast	ZNW:EKV:VRK:HET
volkorentoastjes	volkorentoast	ZNW:MRV:VRK:DE_
voetengestamp	voetengestamp	ZNW:EKV:HET
voegenband	voegenband	ZNW:EKV:DE_
voegenbanden	voegenband	ZNW:MRV:DE_
vliegtuigsmokkel	vliegtuigsmokkel	ZNW:EKV:DE_
uitschrijfformulier	uitschrijfformulier	ZNW:EKV:HET
uitschrijfformulieren	uitschrijfformulier	ZNW:MRV:DE_
twittergedrag	twittergedrag	ZNW:EKV:HET
tuinstadgedachte	tuinstadgedachte	ZNW:EKV:DE_
transgenderbeweging	transgenderbeweging	ZNW:EKV:DE_
transgenderbewegingen	transgenderbeweging	ZNW:MRV:DE_
temperatuurregulerend	temperatuurregulerend	BNW:STL:ONV
temperatuurregulerende	temperatuurregulerend	BNW:STL:VRB
varicellavaccin	varicellavaccin	ZNW:EKV:HET
varicellavaccins	varicellavaccin	ZNW:MRV:DE_
valstrikmijn	valstrikmijn	ZNW:EKV:DE_
valstrikmijnen	valstrikmijn	ZNW:MRV:DE_
synchroonzwemmer	synchroonzwemmer	ZNW:EKV:DE_
synchroonzwemmers	synchroonzwemmer	ZNW:MRV:DE_
visserijhulpbron	visserijhulpbron	ZNW:EKV:DE_
visserijhulpbronnen	visserijhulpbron	ZNW:MRV:DE_
verdedigingswond	verdedigingswond	ZNW:EKV:DE_
verdedigingswonden	verdedigingswond	ZNW:MRV:DE_
vadergevoelen	vadergevoelen	ZNW:EKV:HET
vadergevoelens	vadergevoelen	ZNW:MRV:DE_
vadergevoel	vadergevoel	ZNW:EKV:HET
grijsgeverfd	grijsgeverfd	BNW:STL:ONV
gagelstruweel	gagelstruweel	ZNW:EKV:HET
gagelstruwelen	gagelstruweel	ZNW:MRV:DE_
afvalscheiden	afvalscheiden	WKW:INF:ZNW:HET
zilverlamé	zilverlamé	ZNW:EKV:HET
zelfgerapporteerde	zelfgerapporteerd	BNW:STL:VRB
grijsgeverfde	grijsgeverfd	BNW:STL:VRB
thorarol	thorarol	ZNW:EKV:DE_
thorarollen	thorarol	ZNW:MRV:DE_
openbedrijvendag	openbedrijvendag	ZNW:EKV:DE_
openbedrijvendagen	openbedrijvendag	ZNW:MRV:DE_
kloondier	kloondier	ZNW:EKV:HET
kloondieren	kloondier	ZNW:MRV:DE_
kinderdoodslag	kinderdoodslag	ZNW:EKV:DE_
intermediair-verzekeraar	intermediair-verzekeraar	ZNW:EKV:DE_
grootondernemer	grootondernemer	ZNW:EKV:DE_
grootondernemers	grootondernemer	ZNW:MRV:DE_
geitenwollensokkentype	geitenwollensokkentype	ZNW:EKV:HET
geitenwollensokkentypen	geitenwollensokkentype	ZNW:MRV:DE_
geitenwollensokkentypes	geitenwollensokkentype	ZNW:MRV:DE_
commercialisme	commercialisme	ZNW:EKV:HET
abonnementsysteem	abonnementsysteem	ZNW:EKV:HET
abonnementsystemen	abonnementsysteem	ZNW:MRV:DE_
wederopkomst	wederopkomst	ZNW:EKV:DE_
meldingplichtigen	meldingplichtige	ZNW:MRV:DE_
intermediair-verzekeraars	intermediair-verzekeraar	ZNW:MRV:DE_
intermediairs-verzekeraars	intermediair-verzekeraar	ZNW:MRV:DE_
toongevend	toongevend	BNW:STL:ONV
seniories	seniorie	ZNW:MRV:DE_
tabakindustrie	tabakindustrie	ZNW:EKV:DE_
stallingkosten	stallingkosten	ZNW:MRV:DE_
sedermaaltijd	sedermaaltijd	ZNW:EKV:DE_
sedermaaltijden	sedermaaltijd	ZNW:MRV:DE_
premierbonus	premierbonus	ZNW:EKV:DE_
polderjihadist	polderjihadist	ZNW:EKV:DE_
polderjihadisten	polderjihadist	ZNW:MRV:DE_
teruggroeten	teruggroeten	WKW:TGW:INF
meldingplichtige	meldingplichtig	BNW:STL:VRB
kraplappen	kraplap	ZNW:MRV:DE_
hackbevoegdheid	hackbevoegdheid	ZNW:EKV:DE_
hackbevoegdheden	hackbevoegdheid	ZNW:MRV:DE_
grootmeesterlijk	grootmeesterlijk	BNW:STL:ONV
grensoverschrijder	grensoverschrijder	ZNW:EKV:DE_
freelancefotograaf	freelancefotograaf	ZNW:EKV:DE_
freelancefotografen	freelancefotograaf	ZNW:MRV:DE_
contraproductiviteit	contraproductiviteit	ZNW:EKV:DE_
beroepsprovocateur	beroepsprovocateur	ZNW:EKV:DE_
beroepsprovocateurs	beroepsprovocateur	ZNW:MRV:DE_
automotivesector	automotivesector	ZNW:EKV:DE_
automotivesectoren	automotivesector	ZNW:MRV:DE_
acteurschap	acteurschap	ZNW:EKV:HET
zwaanridder	zwaanridder	ZNW:EKV:DE_
zwaanridders	zwaanridder	ZNW:MRV:DE_
acteurschappen	acteurschap	ZNW:MRV:DE_
Zwaanridder	Zwaanridder	ZNW:EKV:DE_
grootmeesterlijke	grootmeesterlijk	BNW:STL:VRB
kraplapje	kraplap	ZNW:EKV:VRK:HET
toongevende	toongevend	BNW:STL:VRB
toongevenden	toongevend	BNW:STL:MRV:DE_
